,score,title,ups,downs,num_comments,selftext,processed_title_and_text,vectorized_processed_title_and_text,rounded_score
909,4,Who here has the cajones to play JPM earnings tomorrow?,5,1,10,"If so, buy or sell?","['who', 'cajon', 'play', 'jpm', 'earn', 'tomorrow', '?', 'if', ',', 'buy', 'sell', '?']",[1 0 0 ... 0 0 0],5
925,3,Possible inverted head and shoulders on the 60m SPY chart,3,0,3,,"['possibl', 'invert', 'head', 'shoulder', '60m', 'spi', 'chart', 'nan']",[0 0 0 ... 0 0 0],5
974,3,Steve Wozniak says AAPL to $1000,3,0,12,"CNBC has him on at 2pm, they showed a clip of the interview and the Woz says AAPL $1000 in the cards.

","['steve', 'wozniak', 'say', 'aapl', '$', '1000', 'cnbc', '2pm', ',', 'show', 'clip', 'interview', 'woz', 'say', 'aapl', '$', '1000', 'card', '.']",[1 1 0 ... 0 0 0],5
765,5,GBP/JPY Trade Plan &amp; Outcome,7,2,6,"This was a simple support and resistance play.

[GBP/JPY Plan](http://i.imgur.com/ESvWa.png)

[GBP/JPY Outcome](http://i.imgur.com/bxg9r.png)

I waited for GBP/JPY to trade down into the lower support level, which coincided exactly with the 38% retracement. When price moved into the lower level it was immediately rejected. This was my signal to enter long. 

Stops went behind the low, which meant I needed a stop of ~30 pips. The trade was closed for ~260 pips.","['gbp/jpi', 'trade', 'plan', '&', 'amp', ';', 'outcom', 'thi', 'simpl', 'support', 'resist', 'play', '.', '[', 'gbp/jpi', 'plan', ']', '(', 'http', ':', '//i.imgur.com/esvwa.png', ')', '[', 'gbp/jpi', 'outcom', ']', '(', 'http', ':', '//i.imgur.com/bxg9r.png', ')', 'i', 'wait', 'gbp/jpi', 'trade', 'lower', 'support', 'level', ',', 'coincid', 'exactli', '38', '%', 'retrac', '.', 'when', 'price', 'move', 'lower', 'level', 'immedi', 'reject', '.', 'thi', 'signal', 'enter', 'long', '.', 'stop', 'went', 'behind', 'low', ',', 'meant', 'i', 'need', 'stop', '~30', 'pip', '.', 'the', 'trade', 'close', '~260', 'pip', '.']",[2 6 0 ... 0 0 0],5
911,4,Najarian saying Aug 36 calls getting action on FB,6,2,4,"Fast Money - Najarian saying he sees a roll into the Aug 36 calls on FB, are the aiming for the IPO price?

$33.50 looks like the level to beat, Im not a fan at these levels.","['najarian', 'say', 'aug', '36', 'call', 'get', 'action', 'fb', 'fast', 'money', '-', 'najarian', 'say', 'see', 'roll', 'aug', '36', 'call', 'fb', ',', 'aim', 'ipo', 'price', '?', '$', '33.50', 'look', 'like', 'level', 'beat', ',', 'im', 'fan', 'level', '.']",[2 1 0 ... 0 0 0],5
244,8,"S&amp;P movement: is this a coincidence?
",9,1,9,"Reviewing the S&amp;P data today and noticed the following:

The previous bull market from Oct of 2002 started at 768.43 and ended on Nov of 2007 at 1576.09 was a change of **807.66** points.

The current bull market from March of 2009 started at 666.79 with last month's top of 1474.58 has gained **807.79** points.

807.66 vs. 807.79

Is this a coincidence?  Perhaps.  But It's interesting and is food for though.

Ps. If you like numerology and you round those numbers up, you get 808 vs 808, heh.
","['s', '&', 'amp', ';', 'p', 'movement', ':', 'coincid', '?', 'review', 's', '&', 'amp', ';', 'p', 'data', 'today', 'notic', 'follow', ':', 'the', 'previou', 'bull', 'market', 'oct', '2002', 'start', '768.43', 'end', 'nov', '2007', '1576.09', 'chang', '*', '*', '807.66', '*', '*', 'point', '.', 'the', 'current', 'bull', 'market', 'march', '2009', 'start', '666.79', 'last', 'month', ""'s"", 'top', '1474.58', 'gain', '*', '*', '807.79', '*', '*', 'point', '.', '807.66', 'vs.', '807.79', 'is', 'coincid', '?', 'perhap', '.', 'but', 'it', ""'s"", 'interest', 'food', 'though', '.', 'ps', '.', 'if', 'like', 'numerolog', 'round', 'number', ',', 'get', '808', 'vs', '808', ',', 'heh', '.']",[2 6 0 ... 0 0 0],10
299,7,2012 year in review (Long!),10,3,1,,"['2012', 'year', 'review', '(', 'long', '!', ')', 'nan']",[0 0 0 ... 0 0 0],5
381,6,The Trade: The Apple Bottom Is In as Cook Steps Up,19,13,4,,"['the', 'trade', ':', 'the', 'appl', 'bottom', 'is', 'in', 'cook', 'step', 'up', 'nan']",[0 0 0 ... 0 0 0],5
296,6,Buy buy buy! Reddit raising venture financing!,11,5,5,,"['buy', 'buy', 'buy', '!', 'reddit', 'rais', 'ventur', 'financ', '!', 'nan']",[0 0 0 ... 0 0 0],5
49,13,Marijuana May Be The Next Big Growth Sector In The U.S. Stock Market ,21,8,15,,"['marijuana', 'may', 'be', 'the', 'next', 'big', 'growth', 'sector', 'in', 'the', 'u.s.', 'stock', 'market', 'nan']",[0 0 0 ... 0 0 0],15
722,5,PCX filing for bankruptcy? Stock halted.,5,0,4,,"['pcx', 'file', 'bankruptci', '?', 'stock', 'halt', '.', 'nan']",[0 1 0 ... 0 0 0],5
800,4,"ZNGA +16% on Facebook hype, this is overdone",4,0,10,"ZNGA hitting 12.50 here, people are buying it because of its relationship to FB which is a stupid reason to rally.

Downside coming soon.

http://finviz.com/chart.ashx?t=ZNGA&amp;ty=c&amp;ta=1&amp;p=d&amp;s=l","['znga', '+16', '%', 'facebook', 'hype', ',', 'overdon', 'znga', 'hit', '12.50', ',', 'peopl', 'buy', 'relationship', 'fb', 'stupid', 'reason', 'ralli', '.', 'downsid', 'come', 'soon', '.', 'http', ':', '//finviz.com/chart.ashx', '?', 't=znga', '&', 'amp', ';', 'ty=c', '&', 'amp', ';', 'ta=1', '&', 'amp', ';', 'p=d', '&', 'amp', ';', 's=l']",[2 2 0 ... 0 0 0],5
541,5,Asian Markets Up on Chinese Manufacturing and US Home Sales Figures - IBTimes UK,5,0,0,,"['asian', 'market', 'up', 'chines', 'manufactur', 'us', 'home', 'sale', 'figur', '-', 'ibtim', 'uk', 'nan']",[0 0 0 ... 0 0 0],5
342,7,CSCO hit AH -8.5%,8,1,9,"European weakness blamed... prepare to hear a lot of that heading forward.

Reuters- Network equipment maker Cisco Systems (CSCO) beat third quarter earnings estimates, allaying some concerns about global technology spending even as questions remained about the San Jose company's ability to weather economic weakness.

Earnings, excluding items, were 48 cents per share compared with the average estimate of 47 cents a share as compiled by Thomson Reuters.

Revenue rose 6.6 percent from the year-ago quarter to $11.59 billion, compared with a Street view of $11.58 billion, the company said on Wednesday","['csco', 'hit', 'ah', '-8.5', '%', 'european', 'weak', 'blame', '...', 'prepar', 'hear', 'lot', 'head', 'forward', '.', 'reuters-', 'network', 'equip', 'maker', 'cisco', 'system', '(', 'csco', ')', 'beat', 'third', 'quarter', 'earn', 'estim', ',', 'allay', 'concern', 'global', 'technolog', 'spend', 'even', 'question', 'remain', 'san', 'jose', 'compani', ""'s"", 'abil', 'weather', 'econom', 'weak', '.', 'earn', ',', 'exclud', 'item', ',', '48', 'cent', 'per', 'share', 'compar', 'averag', 'estim', '47', 'cent', 'share', 'compil', 'thomson', 'reuter', '.', 'revenu', 'rose', '6.6', 'percent', 'year-ago', 'quarter', '$', '11.59', 'billion', ',', 'compar', 'street', 'view', '$', '11.58', 'billion', ',', 'compani', 'said', 'wednesday']",[5 3 0 ... 0 0 0],5
899,3,MSFT - What do you think? (noob),4,1,5,"I'm still figuring out the terminology and stuff so please correct me if I'm wrong but it looks like there's some resistance around 29.19 and oversold territory looked like 29.21. I know I missed a pretty good enter point around 29.15 but I'm shooting for something a long that range. 29.10-29.15. 

Does any of that seem right?","['msft', '-', 'what', 'think', '?', '(', 'noob', ')', 'i', ""'m"", 'still', 'figur', 'terminolog', 'stuff', 'pleas', 'correct', 'i', ""'m"", 'wrong', 'look', 'like', ""'s"", 'resist', 'around', '29.19', 'oversold', 'territori', 'look', 'like', '29.21', '.', 'i', 'know', 'i', 'miss', 'pretti', 'good', 'enter', 'point', 'around', '29.15', 'i', ""'m"", 'shoot', 'someth', 'long', 'rang', '.', '29.10-29.15', '.', 'doe', 'seem', 'right', '?']",[0 3 0 ... 0 0 0],5
533,6,Asian Markets Sink as US 'Fiscal Cliff' Fears Set In - IBTimes UK,6,0,0,,"['asian', 'market', 'sink', 'us', ""'fiscal"", 'cliff', ""'"", 'fear', 'set', 'in', '-', 'ibtim', 'uk', 'nan']",[0 0 0 ... 0 0 0],5
656,5,"50dma on SPY coming up, has been support so far... (TA within)",6,1,46,,"['50dma', 'spi', 'come', ',', 'support', 'far', '...', '(', 'ta', 'within', ')', 'nan']",[1 0 0 ... 0 0 0],5
989,3,I need some help understanding Facebook's IPO,3,0,2,"So I'm an amateur in the market and have been tracking Facebook's path toward an IPO for a couple of weeks now. My question (as related to the article) is what does it mean for Facebook to raise $5bn for their Internet IPO? When could we expect to see Facebook begin public trading? Any predictions as to how much shares will begin to trade for? (i.e. Google is at around $500 now) 

Here's the link

http://www.bbc.co.uk/news/business-16830664


I know I'm a noob, I really appreciate y'all taking the time to read this.","['i', 'need', 'help', 'understand', 'facebook', ""'s"", 'ipo', 'so', 'i', ""'m"", 'amateur', 'market', 'track', 'facebook', ""'s"", 'path', 'toward', 'ipo', 'coupl', 'week', '.', 'my', 'question', '(', 'relat', 'articl', ')', 'mean', 'facebook', 'rais', '$', '5bn', 'internet', 'ipo', '?', 'when', 'could', 'expect', 'see', 'facebook', 'begin', 'public', 'trade', '?', 'ani', 'predict', 'much', 'share', 'begin', 'trade', '?', '(', 'i.e', '.', 'googl', 'around', '$', '500', ')', 'here', ""'s"", 'link', 'http', ':', '//www.bbc.co.uk/news/business-16830664', 'i', 'know', 'i', ""'m"", 'noob', ',', 'i', 'realli', 'appreci', ""y'all"", 'take', 'time', 'read', '.']",[1 3 0 ... 0 0 0],5
587,4,Fitch downgrades Spain to BBB,6,2,5,What took them this long? :P,"['fitch', 'downgrad', 'spain', 'bbb', 'what', 'took', 'long', '?', ':', 'p']",[0 0 0 ... 0 0 0],5
572,4,"S&amp;P vs EURUSD, divergence here",6,2,8,,"['s', '&', 'amp', ';', 'p', 'vs', 'eurusd', ',', 'diverg', 'nan']",[1 0 0 ... 0 0 0],5
33,18,Buffett: 'Shot Heard Around the World' Coming,18,0,3,,"['buffett', ':', ""'shot"", 'heard', 'around', 'world', ""'"", 'come', 'nan']",[0 0 0 ... 0 0 0],20
31,19,To all: Help keep r/stockmarket current with breaking news!,20,1,16,"The goal of r/stockmarket is to cater to the more active traders here on Reddit.

How can you help?

Easy!

Simply drop by any of the major financial portals, see what news is moving the market, or what earnings may come next week. Anything an active trader needs is very helpful!

Sources of news:

http://www.google.com/finance

http://finance.yahoo.com/

http://blogs.wsj.com/

http://www.zerohedge.com/


or anything else that traders will find useful!

You can either link it directly, or make a text post with the link and some comments of you own.

Here on r/stockmarket we love charts, a good source for charts, complete with predrawn trenline goodness, comes from http://www.finviz.com/quote.ashx?t=ge&amp;ty=c&amp;ta=1&amp;p=d - Check out that GE, nice drop but still in that pretty uptrend.



Thanks for helping!

SJ

","['to', ':', 'help', 'keep', 'r/stockmarket', 'current', 'break', 'news', '!', 'the', 'goal', 'r/stockmarket', 'cater', 'activ', 'trader', 'reddit', '.', 'how', 'help', '?', 'easi', '!', 'simpli', 'drop', 'major', 'financi', 'portal', ',', 'see', 'news', 'move', 'market', ',', 'earn', 'may', 'come', 'next', 'week', '.', 'anyth', 'activ', 'trader', 'need', 'help', '!', 'sourc', 'news', ':', 'http', ':', '//www.google.com/fin', 'http', ':', '//finance.yahoo.com/', 'http', ':', '//blogs.wsj.com/', 'http', ':', '//www.zerohedge.com/', 'anyth', 'els', 'trader', 'find', 'use', '!', 'you', 'either', 'link', 'directli', ',', 'make', 'text', 'post', 'link', 'comment', '.', 'here', 'r/stockmarket', 'love', 'chart', ',', 'good', 'sourc', 'chart', ',', 'complet', 'predrawn', 'trenlin', 'good', ',', 'come', 'http', ':', '//www.finviz.com/quote.ashx', '?', 't=ge', '&', 'amp', ';', 'ty=c', '&', 'amp', ';', 'ta=1', '&', 'amp', ';', 'p=d', '-', 'check', 'ge', ',', 'nice', 'drop', 'still', 'pretti', 'uptrend', '.', 'thank', 'help', '!', 'sj']",[7 4 0 ... 0 0 0],20
743,3,Stock Market Today: Biggest % Gainers June 6,5,2,0,"Into the first hour of trading, the markets are having a nice relief rally with bond yields ticking higher. The biggest % movers are:

ASTI(F)	Ascent Solar Technologies Inc	0.88	51.21%

LEE	LEE Enterprises	1.36	18.26%

HOV	Hovnanian Enterprises Cl 'A'	1.93	13.53%

USLV	VS 3X Silver	28.27	11.21%

ACOM	Ancestry.com Inc	24.94	10.21%

RUSL	Direxion Daily Russia Bull 3x	21.00	9.95%

GASL	Direxion Daily Nat Gas 3X Bull	20.54	9.72%

IRM	Iron Mountain Inc	31.06	9.37%

GWRE	Guidewire Software Inc	26.50	9.23%

INVN	INVN	10.98	8.71%

","['stock', 'market', 'today', ':', 'biggest', '%', 'gainer', 'june', '6', 'into', 'first', 'hour', 'trade', ',', 'market', 'nice', 'relief', 'ralli', 'bond', 'yield', 'tick', 'higher', '.', 'the', 'biggest', '%', 'mover', ':', 'asti', '(', 'f', ')', 'ascent', 'solar', 'technolog', 'inc', '0.88', '51.21', '%', 'lee', 'lee', 'enterpris', '1.36', '18.26', '%', 'hov', 'hovnanian', 'enterpris', 'cl', ""'"", ""a'"", '1.93', '13.53', '%', 'uslv', 'vs', '3x', 'silver', '28.27', '11.21', '%', 'acom', 'ancestry.com', 'inc', '24.94', '10.21', '%', 'rusl', 'direxion', 'daili', 'russia', 'bull', '3x', '21.00', '9.95', '%', 'gasl', 'direxion', 'daili', 'nat', 'ga', '3x', 'bull', '20.54', '9.72', '%', 'irm', 'iron', 'mountain', 'inc', '31.06', '9.37', '%', 'gwre', 'guidewir', 'softwar', 'inc', '26.50', '9.23', '%', 'invn', 'invn', '10.98', '8.71', '%']",[1 1 0 ... 0 0 0],5
192,9,Are desktop computers a dying industry?,14,5,26,,"['are', 'desktop', 'comput', 'die', 'industri', '?', 'nan']",[0 0 0 ... 0 0 0],10
350,8,"SNDK getting whacked AH, Q1 reduced",8,0,0,"Check out the pretty wedge the stock was trading within, looks very obvious after the fact. SNDK was trading flat to slightly lower while the rest of the tech sector was going higher.

Then the fundamental event takes place and triggers the doink.

http://finviz.com/quote.ashx?t=sndk","['sndk', 'get', 'whack', 'ah', ',', 'q1', 'reduc', 'check', 'pretti', 'wedg', 'stock', 'trade', 'within', ',', 'look', 'obviou', 'fact', '.', 'sndk', 'trade', 'flat', 'slightli', 'lower', 'rest', 'tech', 'sector', 'go', 'higher', '.', 'then', 'fundament', 'event', 'take', 'place', 'trigger', 'doink', '.', 'http', ':', '//finviz.com/quote.ashx', '?', 't=sndk']",[2 3 0 ... 0 0 0],10
506,4,Flash Crash in $FDAXM13 exhausted all buyers and skips 3 handles before trading again. Lower Right hand corner of the cap at handles 73-76.,14,10,3,,"['flash', 'crash', '$', 'fdaxm13', 'exhaust', 'buyer', 'skip', '3', 'handl', 'trade', '.', 'lower', 'right', 'hand', 'corner', 'cap', 'handl', '73-76.', 'nan']",[0 1 0 ... 0 0 0],5
204,9,What caused the sudden turnaround in stocks over the last hour of trading today?,10,1,8,Any news?  I couldn't find any.,"['what', 'caus', 'sudden', 'turnaround', 'stock', 'last', 'hour', 'trade', 'today', '?', 'ani', 'news', '?', 'i', 'could', ""n't"", 'find', '.']",[0 1 0 ... 0 0 0],10
830,3,May 10th headlines of the morning,4,1,2,,"['may', '10th', 'headlin', 'morn', 'nan']",[0 0 0 ... 0 0 0],5
570,7,Help me learn.  Show me a reason I should get out of C.,8,1,13,"I'll start by defending the fundamentals.  My source of information is here:

http://www.reuters.com/finance/stocks/financialHighlights?symbol=C.N

I see 9 quarters of positive EPS's, and an expected positive EPS announcement on Monday of ~$0.88.  When an EPS of $0.31 was announced last December, the stock was trading at a low of 24.82, just $.36 down from where it is now.  

Further down the page, I see a price to book ratio of 0.42.  I am reading this to mean the price of 1 share of stock is 42/100 of what the physical book value of the company is.  Compare it to these companies:

http://www.reuters.com/finance/stocks/financialHighlights?symbol=JPM.N

http://www.reuters.com/finance/stocks/financialHighlights?symbol=HD.N

http://www.reuters.com/finance/stocks/financialHighlights?symbol=LOW.N

http://www.reuters.com/finance/stocks/financialHighlights?symbol=WDC.O

JPM has a ratio of .73, HD 4.40, LOW 2.08 and WDC of 1.11.  By comparison here, C seems way low on this ratio.

Beta for C is high at 2.5, which explains why it has dropped so quickly compared to the rest of the market, but also means it should explode when the market moves the other direction.

Current PE for C is 7, and the 5 year high PE ratio for C is closer to 55.  The PE ratio is currently at a 5 year low.  We're also nearing the 52 week low for the stock in general.

From a TA standpoint, I'm still holding out hope for a bull flag to make its run on Monday through Wednesday.  I also see C sitting on its support line:

http://www.finviz.com/quote.ashx?t=c&amp;ty=c&amp;ta=1&amp;p=d

So, give me a reason I shouldn't average way down on this guy.  What am I missing?  The only downside I can see is that the beta coorelation to the market is very high, and the S&amp;P seems to be falling hard with a possible target back below 1300.  I just have a very hard time believing it can get back to its June 4th low with no major bankruptcy announcements from Europe as were being expected back on this date.

**Edit:**  Just picked up another 150 shares at 25.33.  Wish me luck.  
","['help', 'learn', '.', 'show', 'reason', 'i', 'get', 'c.', 'i', ""'ll"", 'start', 'defend', 'fundament', '.', 'my', 'sourc', 'inform', ':', 'http', ':', '//www.reuters.com/finance/stocks/financialhighlight', '?', 'symbol=c.n', 'i', 'see', '9', 'quarter', 'posit', 'ep', ""'s"", ',', 'expect', 'posit', 'ep', 'announc', 'monday', '~', '$', '0.88', '.', 'when', 'ep', '$', '0.31', 'announc', 'last', 'decemb', ',', 'stock', 'trade', 'low', '24.82', ',', '$', '.36', '.', 'further', 'page', ',', 'i', 'see', 'price', 'book', 'ratio', '0.42', '.', 'i', 'read', 'mean', 'price', '1', 'share', 'stock', '42/100', 'physic', 'book', 'valu', 'compani', '.', 'compar', 'compani', ':', 'http', ':', '//www.reuters.com/finance/stocks/financialhighlight', '?', 'symbol=jpm.n', 'http', ':', '//www.reuters.com/finance/stocks/financialhighlight', '?', 'symbol=hd.n', 'http', ':', '//www.reuters.com/finance/stocks/financialhighlight', '?', 'symbol=low.n', 'http', ':', '//www.reuters.com/finance/stocks/financialhighlight', '?', 'symbol=wdc.o', 'jpm', 'ratio', '.73', ',', 'hd', '4.40', ',', 'low', '2.08', 'wdc', '1.11', '.', 'by', 'comparison', ',', 'c', 'seem', 'way', 'low', 'ratio', '.', 'beta', 'c', 'high', '2.5', ',', 'explain', 'drop', 'quickli', 'compar', 'rest', 'market', ',', 'also', 'mean', 'explod', 'market', 'move', 'direct', '.', 'current', 'pe', 'c', '7', ',', '5', 'year', 'high', 'pe', 'ratio', 'c', 'closer', '55', '.', 'the', 'pe', 'ratio', 'current', '5', 'year', 'low', '.', 'we', ""'re"", 'also', 'near', '52', 'week', 'low', 'stock', 'gener', '.', 'from', 'ta', 'standpoint', ',', 'i', ""'m"", 'still', 'hold', 'hope', 'bull', 'flag', 'make', 'run', 'monday', 'wednesday', '.', 'i', 'also', 'see', 'c', 'sit', 'support', 'line', ':', 'http', ':', '//www.finviz.com/quote.ashx', '?', 't=c', '&', 'amp', ';', 'ty=c', '&', 'amp', ';', 'ta=1', '&', 'amp', ';', 'p=d', 'so', ',', 'give', 'reason', 'i', ""n't"", 'averag', 'way', 'guy', '.', 'what', 'i', 'miss', '?', 'the', 'downsid', 'i', 'see', 'beta', 'coorel', 'market', 'high', ',', 's', '&', 'amp', ';', 'p', 'seem', 'fall', 'hard', 'possibl', 'target', 'back', '1300', '.', 'i', 'hard', 'time', 'believ', 'get', 'back', 'june', '4th', 'low', 'major', 'bankruptci', 'announc', 'europ', 'expect', 'back', 'date', '.', '*', '*', 'edit', ':', '*', '*', 'just', 'pick', 'anoth', '150', 'share', '25.33', '.', 'wish', 'luck', '.']",[13 18  0 ...  0  0  0],5
692,3,"Bull Markets Die Hard, Here’s How This One Could End",6,3,1,,"['bull', 'market', 'die', 'hard', ',', 'here', '’', 'how', 'thi', 'one', 'could', 'end', 'nan']",[1 0 0 ... 0 0 0],5
109,11,My analysis suggests an S&amp;P500 Top of around 1700,23,12,7,,"['my', 'analysi', 'suggest', 's', '&', 'amp', ';', 'p500', 'top', 'around', '1700', 'nan']",[0 0 0 ... 0 0 0],10
941,3,Trying the ES futures long trade again,3,0,4,"1340 on the ES, or 1342 on the S&amp;P is a downtrending resistance that is holding this market down, Im taking along here 1337ish. 

GOOG is +3% here, I suspect we start seeing more rumblings about QE3 which will spark our next leg higher.","['tri', 'es', 'futur', 'long', 'trade', '1340', 'es', ',', '1342', 's', '&', 'amp', ';', 'p', 'downtrend', 'resist', 'hold', 'market', ',', 'im', 'take', 'along', '1337ish', '.', 'goog', '+3', '%', ',', 'i', 'suspect', 'start', 'see', 'rumbl', 'qe3', 'spark', 'next', 'leg', 'higher', '.']",[3 2 0 ... 0 0 0],5
77,14,I'm calling a top in equities. If I'm wrong I lose a couple hundred bucks - so what. If I'm right i could make tens of thousands.,20,6,65,"Mostly I just want to say ""called it."" I think everyone is thinking it in the back of their head. I'm buying OOM long-term puts. I could totally be wrong, but I would rather be wrong than kicking my ass for not acting on it.

This indicator is what made me do it: https://research.stlouisfed.org/fred2/graph/?graph_id=102224&amp;category_id=0

It usually leads recessions by a few months. It last retracted in 2001 and 2007.

Then, the SP is at resistance http://imgur.com/S6WHRHz

And all-time highs while everything else is at 1-2 year lows.

It makes no sense. ","['i', ""'m"", 'call', 'top', 'equiti', '.', 'if', 'i', ""'m"", 'wrong', 'i', 'lose', 'coupl', 'hundr', 'buck', '-', '.', 'if', 'i', ""'m"", 'right', 'could', 'make', 'ten', 'thousand', '.', 'mostli', 'i', 'want', 'say', '``', 'call', '.', ""''"", 'i', 'think', 'everyon', 'think', 'back', 'head', '.', 'i', ""'m"", 'buy', 'oom', 'long-term', 'put', '.', 'i', 'could', 'total', 'wrong', ',', 'i', 'would', 'rather', 'wrong', 'kick', 'ass', 'act', '.', 'thi', 'indic', 'made', ':', 'http', ':', '//research.stlouisfed.org/fred2/graph/', '?', 'graph_id=102224', '&', 'amp', ';', 'category_id=0', 'it', 'usual', 'lead', 'recess', 'month', '.', 'it', 'last', 'retract', '2001', '2007', '.', 'then', ',', 'sp', 'resist', 'http', ':', '//imgur.com/s6whrhz', 'and', 'all-tim', 'high', 'everyth', 'els', '1-2', 'year', 'low', '.', 'it', 'make', 'sens', '.']",[ 2 11  0 ...  0  0  0],15
84,12,Knight seeks financing after $440 million loss; shares drop,15,3,11,,"['knight', 'seek', 'financ', '$', '440', 'million', 'loss', ';', 'share', 'drop', 'nan']",[0 0 0 ... 0 0 0],10
280,7,Closing my S&amp;P futures long position here,9,2,21,,"['close', 's', '&', 'amp', ';', 'p', 'futur', 'long', 'posit', 'nan']",[0 0 0 ... 0 0 0],5
82,15,Mysterious Algorithm Was 4% of Trading Activity Last Week,18,3,10,,"['mysteri', 'algorithm', 'wa', '4', '%', 'trade', 'activ', 'last', 'week', 'nan']",[0 0 0 ... 0 0 0],15
539,5,Asian Markets Down on Gloomy Corporate Earnings - IBTimes UK,5,0,0,,"['asian', 'market', 'down', 'gloomi', 'corpor', 'earn', '-', 'ibtim', 'uk', 'nan']",[0 0 0 ... 0 0 0],5
495,5,"Oil futures spike, Im long some ES for a bounce.",8,3,8,"I took some ES at 1557.75 long, I think we see a turn-around-Tuesday tomorrow.

A nice spike in oil futures is helping, now only if AAPL can get some bulls behind it, we could see that move back over 1600.

Short term bullish, but I still feel the trend is down.","['oil', 'futur', 'spike', ',', 'im', 'long', 'es', 'bounc', '.', 'i', 'took', 'es', '1557.75', 'long', ',', 'i', 'think', 'see', 'turn-around-tuesday', 'tomorrow', '.', 'a', 'nice', 'spike', 'oil', 'futur', 'help', ',', 'aapl', 'get', 'bull', 'behind', ',', 'could', 'see', 'move', 'back', '1600', '.', 'short', 'term', 'bullish', ',', 'i', 'still', 'feel', 'trend', '.']",[5 4 0 ... 0 0 0],5
442,6,"Im not buying this rally, short term good news but nothing really changing",8,2,29,"So the headline was: The euro zone will move to create a single banking supervisor “involving the ECB”.

Ok, so whats that? They will have a more centralized body to be able to handle these problems? 

Just more can kicking, nothing is going to change by next week.","['im', 'buy', 'ralli', ',', 'short', 'term', 'good', 'news', 'noth', 'realli', 'chang', 'so', 'headlin', ':', 'the', 'euro', 'zone', 'move', 'creat', 'singl', 'bank', 'supervisor', '“', 'involv', 'ecb', '”', '.', 'ok', ',', 'what', '?', 'they', 'central', 'bodi', 'abl', 'handl', 'problem', '?', 'just', 'kick', ',', 'noth', 'go', 'chang', 'next', 'week', '.']",[3 2 0 ... 0 0 0],5
906,3,What are some trustworthy and inexpensive trading websites?,3,0,16,I went to visit a broker at Edward Jones today and I found out that the minimum cost just to buy would be $55.00 and along with sell $110.00 in total. I don't have too big of a capital to invest and I would like to buy and sell stocks without having to worry too much about the cost of trading fees. Do you guys know any good websites that offer inexpensive trading? ,"['what', 'trustworthi', 'inexpens', 'trade', 'websit', '?', 'i', 'went', 'visit', 'broker', 'edward', 'jone', 'today', 'i', 'found', 'minimum', 'cost', 'buy', 'would', '$', '55.00', 'along', 'sell', '$', '110.00', 'total', '.', 'i', ""n't"", 'big', 'capit', 'invest', 'i', 'would', 'like', 'buy', 'sell', 'stock', 'without', 'worri', 'much', 'cost', 'trade', 'fee', '.', 'do', 'guy', 'know', 'good', 'websit', 'offer', 'inexpens', 'trade', '?']",[0 2 0 ... 0 0 0],5
309,6,OSG drops 70% on fears of a potential bankruptcy protection,8,2,0,,"['osg', 'drop', '70', '%', 'fear', 'potenti', 'bankruptci', 'protect', 'nan']",[0 0 0 ... 0 0 0],5
516,7,KASS: I Hear Apple Is Going To Announce A Stock Split Tomorrow,15,8,10,,"['kass', ':', 'i', 'hear', 'appl', 'is', 'go', 'to', 'announc', 'a', 'stock', 'split', 'tomorrow', 'nan']",[0 0 0 ... 0 0 0],5
736,4,President of JCP leaving effective immediately. Just the latest sign of Ron Johnson's poor transition. Looks like a juicy short with not much support below.,7,3,7,,"['presid', 'jcp', 'leav', 'effect', 'immedi', '.', 'just', 'latest', 'sign', 'ron', 'johnson', ""'s"", 'poor', 'transit', '.', 'look', 'like', 'juici', 'short', 'much', 'support', '.', 'nan']",[0 3 0 ... 0 0 0],5
2,42,Report That Caused Spanish Markets To Collapse,59,17,1,,"['report', 'that', 'caus', 'spanish', 'market', 'to', 'collaps', 'nan']",[0 0 0 ... 0 0 0],40
101,14,"Facebook's Failbook IPO, or how Silicon Valley needs to realize the rest of the world just doesn't care",15,1,5,,"['facebook', ""'s"", 'failbook', 'ipo', ',', 'silicon', 'valley', 'need', 'realiz', 'rest', 'world', ""n't"", 'care', 'nan']",[1 0 0 ... 0 0 0],15
490,5,X-post: What do the technicals say about bitcoin?,8,3,7,,"['x-post', ':', 'what', 'technic', 'say', 'bitcoin', '?', 'nan']",[0 0 0 ... 0 0 0],5
707,4,"Facebook Q2 Report, in Slides (I like graphs)",4,0,1,,"['facebook', 'q2', 'report', ',', 'slide', '(', 'i', 'like', 'graph', ')', 'nan']",[1 0 0 ... 0 0 0],5
894,3,"GM, Ford Sales Stall in July; Is Trend Turning?",3,0,0,,"['gm', ',', 'ford', 'sale', 'stall', 'juli', ';', 'is', 'trend', 'turn', '?', 'nan']",[1 0 0 ... 0 0 0],5
208,7,Buying AAPL Jun 580 calls @5.50,10,3,38,"Taking a shot at some AAPL calls, Jun 580 calls @5.50

AAPL hit $534 this morning, I think this is a pretty good area for a potential bounce.","['buy', 'aapl', 'jun', '580', 'call', '@', '5.50', 'take', 'shot', 'aapl', 'call', ',', 'jun', '580', 'call', '@', '5.50', 'aapl', 'hit', '$', '534', 'morn', ',', 'i', 'think', 'pretti', 'good', 'area', 'potenti', 'bounc', '.']",[2 1 0 ... 0 0 0],5
277,8,Trading Stats for July (TraderVue),9,1,4,"P/L Shown in Ticks
http://cdn.hotstockmarket.com/0/06/063ed3ed_Capture.PNG
Additional stats shown in R-Multiples
http://cdn.hotstockmarket.com/c/c2/c27e00cb_Capture.PNG

Not shown: 9 wins in a row counting my sugar trade that's still going.
I closed it out but then opened it again when I bought at 16.21.
I had the setting clicked to merge trades aggressively so once I re-entered,
it took that away and counted it as an in progress trade.
Total on this trade I'm around +160 ticks. 
What's also not shown is my -90 ticks total in an /NG (natural gas) long right now. ","['trade', 'stat', 'juli', '(', 'tradervu', ')', 'p/l', 'shown', 'tick', 'http', ':', '//cdn.hotstockmarket.com/0/06/063ed3ed_capture.png', 'addit', 'stat', 'shown', 'r-multipl', 'http', ':', '//cdn.hotstockmarket.com/c/c2/c27e00cb_capture.png', 'not', 'shown', ':', '9', 'win', 'row', 'count', 'sugar', 'trade', ""'s"", 'still', 'go', '.', 'i', 'close', 'open', 'i', 'bought', '16.21', '.', 'i', 'set', 'click', 'merg', 'trade', 'aggress', 'i', 're-ent', ',', 'took', 'away', 'count', 'progress', 'trade', '.', 'total', 'trade', 'i', ""'m"", 'around', '+160', 'tick', '.', 'what', ""'s"", 'also', 'shown', '-90', 'tick', 'total', '/ng', '(', 'natur', 'ga', ')', 'long', 'right', '.']",[1 5 0 ... 0 0 0],10
5,28,"Stock Market July 11th top movers, and its my cake day!",34,6,12,"At 10:51am on July 11th, there are the top 10 movers for this morning so far:

CTEL	City Telecom (H.K.) ADS	4.86	24.30%

SSH	Sunshine Heart Inc	15.31	15.11%

SKYW	SkyWest Inc	7.82	13.99%

PAY	Verifone Systems Inc	34.85	9.18%

HOGS	Zhongpin Inc	10.88	8.80%

LXRX	Lexison Pharmaceuticals Inc	2.73	6.86%

OREX	Orexigen Therapeutics Inc	6.37	6.52%

YGE	Yingli Energy Holding Co Ltd	2.86	6.32%

TSL	Trina Solar Ltd	6.25	5.93%

JRCC	James River Coal Co	2.28	5.53%

","['stock', 'market', 'juli', '11th', 'top', 'mover', ',', 'cake', 'day', '!', 'at', '10:51am', 'juli', '11th', ',', 'top', '10', 'mover', 'morn', 'far', ':', 'ctel', 'citi', 'telecom', '(', 'h.k', '.', ')', 'ad', '4.86', '24.30', '%', 'ssh', 'sunshin', 'heart', 'inc', '15.31', '15.11', '%', 'skyw', 'skywest', 'inc', '7.82', '13.99', '%', 'pay', 'verifon', 'system', 'inc', '34.85', '9.18', '%', 'hog', 'zhongpin', 'inc', '10.88', '8.80', '%', 'lxrx', 'lexison', 'pharmaceut', 'inc', '2.73', '6.86', '%', 'orex', 'orexigen', 'therapeut', 'inc', '6.37', '6.52', '%', 'yge', 'yingli', 'energi', 'hold', 'co', 'ltd', '2.86', '6.32', '%', 'tsl', 'trina', 'solar', 'ltd', '6.25', '5.93', '%', 'jrcc', 'jame', 'river', 'coal', 'co', '2.28', '5.53', '%']",[2 1 0 ... 0 0 0],30
54,15,Elliot wave on GDX gold miners commentary on image,16,1,12,,"['elliot', 'wave', 'gdx', 'gold', 'miner', 'commentari', 'imag', 'nan']",[0 0 0 ... 0 0 0],15
536,4,"Asian Markets End Mixed, Bank of Japan's Monetary Plan Fails to Cheer - IBTimes UK",5,1,0,,"['asian', 'market', 'end', 'mix', ',', 'bank', 'japan', ""'s"", 'monetari', 'plan', 'fail', 'cheer', '-', 'ibtim', 'uk', 'nan']",[1 0 0 ... 0 0 0],5
314,6,Long term growth for NWN?,8,2,1,,"['long', 'term', 'growth', 'nwn', '?', 'nan']",[0 0 0 ... 0 0 0],5
866,3,"GMCR spikes +13%, break over resistance?",3,0,3,,"['gmcr', 'spike', '+13', '%', ',', 'break', 'resist', '?', 'nan']",[1 0 0 ... 0 0 0],5
636,4,Will this MACD crossover give a good signal?,8,4,11,,"['will', 'macd', 'crossov', 'give', 'good', 'signal', '?', 'nan']",[0 0 0 ... 0 0 0],5
456,4,Facebook IPO is Overvalued say us losers who are not issued pre-ipo shares,7,3,7,,"['facebook', 'ipo', 'overvalu', 'say', 'us', 'loser', 'issu', 'pre-ipo', 'share', 'nan']",[0 0 0 ... 0 0 0],5
97,11,Will Obama Win? Watch the Dow,15,4,1,,"['will', 'obama', 'win', '?', 'watch', 'dow', 'nan']",[0 0 0 ... 0 0 0],10
260,8,"I will be posting some of my own weekly trade ideas for anyone interested, starting with CAKE.  Thoughts?",15,7,10,,"['i', 'post', 'weekli', 'trade', 'idea', 'anyon', 'interest', ',', 'start', 'cake', '.', 'thought', '?', 'nan']",[1 1 0 ... 0 0 0],10
798,4,AAPL TA chart: Expansions and consolidations,5,1,9,"Just for you exmaniex! ;)

[AAPL Chart](http://i.imgur.com/sSgsU.gif)

Adding $18B in market cap over a few days is a huge move, so I was wondering how previous rallies looked after sideways consolidation moves. 

AAPL can not go higher in a straight line. I think we can all agree on that!

If this rally is like the previous ones, then it would be perfectly normal to see some sideways action start to kick in between here are $511.

(To those of you that do not follow charts, thats fine, these are just my opinions, you may have your own which differ greatly!)","['aapl', 'ta', 'chart', ':', 'expans', 'consolid', 'just', 'exmaniex', '!', ';', ')', '[', 'aapl', 'chart', ']', '(', 'http', ':', '//i.imgur.com/ssgsu.gif', ')', 'ad', '$', '18b', 'market', 'cap', 'day', 'huge', 'move', ',', 'i', 'wonder', 'previou', 'ralli', 'look', 'sideway', 'consolid', 'move', '.', 'aapl', 'go', 'higher', 'straight', 'line', '.', 'i', 'think', 'agre', '!', 'if', 'ralli', 'like', 'previou', 'one', ',', 'would', 'perfectli', 'normal', 'see', 'sideway', 'action', 'start', 'kick', '$', '511', '.', '(', 'to', 'follow', 'chart', ',', 'that', 'fine', ',', 'opinion', ',', 'may', 'differ', 'greatli', '!', ')']",[5 3 0 ... 0 0 0],5
863,3,Asian Markets Fall as US Fiscal Cliff and Greek Bailout Concerns Continue - IBTimes UK,3,0,0,,"['asian', 'market', 'fall', 'us', 'fiscal', 'cliff', 'greek', 'bailout', 'concern', 'continu', '-', 'ibtim', 'uk', 'nan']",[0 0 0 ... 0 0 0],5
770,4,Potential black swan event?  JP Morgan overexposure to selling CDSes,5,1,3,"http://online.wsj.com/article/SB10001424052702303299604577326031119412436.html?mod=wsj_share_tweet

http://www.bloomberg.com/news/2012-04-05/jpmorgan-trader-iksil-s-heft-is-said-to-distort-credit-indexes.html

http://www.zerohedge.com/news/jpmorgan-trader-accused-breaking-cds-index-market-massive-prop-position

http://www.businessinsider.com/bruno-michel-iksil-2012-4?

What do you think will happen if he blows up? Or is this something that is overblown?","['potenti', 'black', 'swan', 'event', '?', 'jp', 'morgan', 'overexposur', 'sell', 'cdse', 'http', ':', '//online.wsj.com/article/sb10001424052702303299604577326031119412436.html', '?', 'mod=wsj_share_tweet', 'http', ':', '//www.bloomberg.com/news/2012-04-05/jpmorgan-trader-iksil-s-heft-is-said-to-distort-credit-indexes.html', 'http', ':', '//www.zerohedge.com/news/jpmorgan-trader-accused-breaking-cds-index-market-massive-prop-posit', 'http', ':', '//www.businessinsider.com/bruno-michel-iksil-2012-4', '?', 'what', 'think', 'happen', 'blow', '?', 'or', 'someth', 'overblown', '?']",[0 0 0 ... 0 0 0],5
408,8,Mark's Weekly Log; Charts and Analysis.,9,1,1,,"['mark', ""'s"", 'weekli', 'log', ';', 'chart', 'analysi', '.', 'nan']",[0 1 0 ... 0 0 0],10
888,4,Central Bank sets Bond Plan,6,2,0,,"['central', 'bank', 'set', 'bond', 'plan', 'nan']",[0 0 0 ... 0 0 0],5
762,5,Amazon (AMZN) earnings: How I risked $320 to make $590.,5,0,5,"Amazon is up huge afterhours due to earnings. The price is just under 225 from a close today of 196. Yesterday I decided to purchase an out-of-the-money May 195/205 bull call spread in order to speculate on Amazon beating on earnings. I paid $4.10 for this spread. To offset some of this cost, I sold a May 165 put for $.97.

165 is support and 195/205 is the 38.2%/50% retracement levels from Oct high to Dec low. I could have chosen a much higher spread like the 205/215 but I wasn't sure how much Amazon was forecasted to move. Normally I like to look at the IV but I didn't have time this time around. In fact, the 205/215 would have probably been a better choice because I would have risked less and probably made more.

Total cash outlay including commissions was $320. If Amazon went below 195 after earnings, I would most likely lose all of the $4.10 i paid for the spread. If Amazon went below 165, I would probably have to purchase AMZN at 165 but be paid $.97 to due so.

Tomorrow I will close the spread out with a nice gain... the 195/205 spread now worth close to $1000. And also Buy to Close the put for a near 100% gain.
","['amazon', '(', 'amzn', ')', 'earn', ':', 'how', 'i', 'risk', '$', '320', 'make', '$', '590', '.', 'amazon', 'huge', 'afterhour', 'due', 'earn', '.', 'the', 'price', '225', 'close', 'today', '196', '.', 'yesterday', 'i', 'decid', 'purchas', 'out-of-the-money', 'may', '195/205', 'bull', 'call', 'spread', 'order', 'specul', 'amazon', 'beat', 'earn', '.', 'i', 'paid', '$', '4.10', 'spread', '.', 'to', 'offset', 'cost', ',', 'i', 'sold', 'may', '165', 'put', '$', '.97', '.', '165', 'support', '195/205', '38.2', '%', '/50', '%', 'retrac', 'level', 'oct', 'high', 'dec', 'low', '.', 'i', 'could', 'chosen', 'much', 'higher', 'spread', 'like', '205/215', 'i', ""n't"", 'sure', 'much', 'amazon', 'forecast', 'move', '.', 'normal', 'i', 'like', 'look', 'iv', 'i', ""n't"", 'time', 'time', 'around', '.', 'in', 'fact', ',', '205/215', 'would', 'probabl', 'better', 'choic', 'i', 'would', 'risk', 'less', 'probabl', 'made', '.', 'total', 'cash', 'outlay', 'includ', 'commiss', '$', '320', '.', 'if', 'amazon', 'went', '195', 'earn', ',', 'i', 'would', 'like', 'lose', '$', '4.10', 'paid', 'spread', '.', 'if', 'amazon', 'went', '165', ',', 'i', 'would', 'probabl', 'purchas', 'amzn', '165', 'paid', '$', '.97', 'due', '.', 'tomorrow', 'i', 'close', 'spread', 'nice', 'gain', '...', '195/205', 'spread', 'worth', 'close', '$', '1000', '.', 'and', 'also', 'buy', 'close', 'put', 'near', '100', '%', 'gain', '.']",[ 4 15  0 ...  0  0  0],5
481,5,What timeframe Moving Averages do you find most useful?,5,0,3,Is there a general rule when determining which moving averages to use? Why is the 200 day moving average so common? And also the 50.,"['what', 'timefram', 'move', 'averag', 'find', 'use', '?', 'is', 'gener', 'rule', 'determin', 'move', 'averag', 'use', '?', 'whi', '200', 'day', 'move', 'averag', 'common', '?', 'and', 'also', '50', '.']",[0 1 0 ... 0 0 0],5
118,11,I'm a stock market noob but want to invest in 3D printing. What do I look for within my research when choosing what to invest in?,13,2,7,,"['i', ""'m"", 'stock', 'market', 'noob', 'want', 'invest', '3d', 'print', '.', 'what', 'i', 'look', 'within', 'research', 'choos', 'invest', '?', 'nan']",[0 1 0 ... 0 0 0],10
773,4,Fun with AAPL,7,3,6,,"['fun', 'aapl', 'nan']",[0 0 0 ... 0 0 0],5
250,9,"Facebook Insider Lock-Up Expiring, good entry point in the next week or so or do you see FB falling further?",11,2,11,,"['facebook', 'insid', 'lock-up', 'expir', ',', 'good', 'entri', 'point', 'next', 'week', 'see', 'fb', 'fall', '?', 'nan']",[1 0 0 ... 0 0 0],10
333,7,"A subreddit for algorithmic trading, ideas and discussion.",11,4,3,"http://www.reddit.com/r/algotrading/

I made this one for a more academic approach to trading, its not meant to replace any of the other current subs but meant to keep the technical points of the discussions to one key place.
","['a', 'subreddit', 'algorithm', 'trade', ',', 'idea', 'discuss', '.', 'http', ':', '//www.reddit.com/r/algotrading/', 'i', 'made', 'one', 'academ', 'approach', 'trade', ',', 'meant', 'replac', 'current', 'sub', 'meant', 'keep', 'technic', 'point', 'discuss', 'one', 'key', 'place', '.']",[2 2 0 ... 0 0 0],5
9,27,I don't understand the stock market,34,7,18,,"['i', ""n't"", 'understand', 'stock', 'market', 'nan']",[0 0 0 ... 0 0 0],25
196,7,Apple Hits New Record North Of $600 Billion In Market Cap,9,2,3,,"['appl', 'hit', 'new', 'record', 'north', 'of', '$', '600', 'billion', 'in', 'market', 'cap', 'nan']",[0 0 0 ... 0 0 0],5
931,3,Trading Stocks: There's an App for that.,5,2,1,,"['trade', 'stock', ':', 'there', ""'s"", 'app', '.', 'nan']",[0 1 0 ... 0 0 0],5
81,13,Hostess attracts over 100 potential bidders ,14,1,4,,"['hostess', 'attract', '100', 'potenti', 'bidder', 'nan']",[0 0 0 ... 0 0 0],15
448,6,Stock Market Today: June 13th biggest movers,7,1,7,"After the first hour of trading, the following stocks are showing the biggest percentage gains:

BSPM	Biostar Pharmaceuticals Inc	1.65	54.21%

USU	Usec Inc	0.96	27.65%

ROSA	iPath SX Russell 1000 TR Index	27.73	25.93%

KITD	KIT digital Inc	3.74	10.98%

HZNP	Horizon Pharma Inc	4.66	10.65%

DNDN	Dendreon Corp	6.89	10.24%

RMBS	Rambus Inc	5.32	9.47%

LCC	US Airways Group Inc	12.46	9.03%

RPTP	Raptor Pharmaceutical Corp	5.92	8.82%

ARNA	Arena Pharmaceuticals	8.49	7.74%



","['stock', 'market', 'today', ':', 'june', '13th', 'biggest', 'mover', 'after', 'first', 'hour', 'trade', ',', 'follow', 'stock', 'show', 'biggest', 'percentag', 'gain', ':', 'bspm', 'biostar', 'pharmaceut', 'inc', '1.65', '54.21', '%', 'usu', 'usec', 'inc', '0.96', '27.65', '%', 'rosa', 'ipath', 'sx', 'russel', '1000', 'tr', 'index', '27.73', '25.93', '%', 'kitd', 'kit', 'digit', 'inc', '3.74', '10.98', '%', 'hznp', 'horizon', 'pharma', 'inc', '4.66', '10.65', '%', 'dndn', 'dendreon', 'corp', '6.89', '10.24', '%', 'rmb', 'rambu', 'inc', '5.32', '9.47', '%', 'lcc', 'us', 'airway', 'group', 'inc', '12.46', '9.03', '%', 'rptp', 'raptor', 'pharmaceut', 'corp', '5.92', '8.82', '%', 'arna', 'arena', 'pharmaceut', '8.49', '7.74', '%']",[1 0 0 ... 0 0 0],5
467,6,"[AAPL] doji on apple's weekly, probably meaningless since Apple only goes up.",7,1,3,,"['[', 'aapl', ']', 'doji', 'appl', ""'s"", 'weekli', ',', 'probabl', 'meaningless', 'sinc', 'appl', 'goe', '.', 'nan']",[1 1 0 ... 0 0 0],5
616,5,"Little bull trap this morning, S&amp;P 1378 touched then sold",6,1,4,"This is not much to go on just yet, but if the S&amp;P can take out yesterdays lows, then I would say we have ourselves a reversal candle on the daily?

For reference sake is everybody comfortable with referring to the S&amp;P futures as ES and the S&amp;P 500 (normal) as cash market?

","['littl', 'bull', 'trap', 'morn', ',', 's', '&', 'amp', ';', 'p', '1378', 'touch', 'sold', 'thi', 'much', 'go', 'yet', ',', 's', '&', 'amp', ';', 'p', 'take', 'yesterday', 'low', ',', 'i', 'would', 'say', 'revers', 'candl', 'daili', '?', 'for', 'refer', 'sake', 'everybodi', 'comfort', 'refer', 's', '&', 'amp', ';', 'p', 'futur', 'es', 's', '&', 'amp', ';', 'p', '500', '(', 'normal', ')', 'cash', 'market', '?']",[3 0 0 ... 0 0 0],5
239,7,Fed Officials Forecast Main Rate to Stay Near Zero Until 2015 ,10,3,7,,"['fed', 'offici', 'forecast', 'main', 'rate', 'stay', 'near', 'zero', 'until', '2015', 'nan']",[0 0 0 ... 0 0 0],5
499,5,"Apple faces ban on older iPhones, iPads after legal defeat | Apple",7,2,5,,"['appl', 'face', 'ban', 'older', 'iphon', ',', 'ipad', 'legal', 'defeat', '|', 'appl', 'nan']",[1 0 0 ... 0 0 0],5
211,8,"Remain bullish for the short term, but keep your eyes on the exit!",9,1,3,,"['remain', 'bullish', 'short', 'term', ',', 'keep', 'eye', 'exit', '!', 'nan']",[1 0 0 ... 0 0 0],10
713,4,Seeking explanation of big BAC drop after earnings,6,2,3,"[http://www.google.com/finance?q=NYSE:BAC](http://www.google.com/finance?q=NYSE:BAC)

[Article](http://www.foxbusiness.com/news/2012/07/18/bank-america-swings-to-2nd-quarter-profit-on-strong-revenue/)

Everything seems rosy.  They exceeded earnings expectations by 40%,  missed revenue expectations by 5%, but indicators are up and they've had a huge recovery from last year.

Does anybody have insights as to why they crashed 5% on a day when the market was largely up?","['seek', 'explan', 'big', 'bac', 'drop', 'earn', '[', 'http', ':', '//www.google.com/fin', '?', 'q=nyse', ':', 'bac', ']', '(', 'http', ':', '//www.google.com/fin', '?', 'q=nyse', ':', 'bac', ')', '[', 'articl', ']', '(', 'http', ':', '//www.foxbusiness.com/news/2012/07/18/bank-america-swings-to-2nd-quarter-profit-on-strong-revenue/', ')', 'everyth', 'seem', 'rosi', '.', 'they', 'exceed', 'earn', 'expect', '40', '%', ',', 'miss', 'revenu', 'expect', '5', '%', ',', 'indic', ""'ve"", 'huge', 'recoveri', 'last', 'year', '.', 'doe', 'anybodi', 'insight', 'crash', '5', '%', 'day', 'market', 'larg', '?']",[2 2 0 ... 0 0 0],5
351,7,Goldman: “BUY BUY BUY!”- Best buyers market in a generation,7,0,8,,"['goldman', ':', '“', 'buy', 'buy', 'buy', '!', '”', '-', 'best', 'buyer', 'market', 'gener', 'nan']",[0 0 0 ... 0 0 0],5
440,5,HPQ - opinions? ,7,2,7,"What's everyone's opinion on Hewlett-Packard at the moment? (http://www.finviz.com/quote.ashx?t=hpq&amp;ty=c&amp;ta=1&amp;p=d)  Horrible year long EPS, long term debt, moving averages, etc., however, it's been trading around the $18 - $20 level for a bit now, which seems like a solid support level.  With such a low PE ratio, it seems like a good value pick to hold on to, and hope it rallies.  Opinions?","['hpq', '-', 'opinion', '?', 'what', ""'s"", 'everyon', ""'s"", 'opinion', 'hewlett-packard', 'moment', '?', '(', 'http', ':', '//www.finviz.com/quote.ashx', '?', 't=hpq', '&', 'amp', ';', 'ty=c', '&', 'amp', ';', 'ta=1', '&', 'amp', ';', 'p=d', ')', 'horribl', 'year', 'long', 'ep', ',', 'long', 'term', 'debt', ',', 'move', 'averag', ',', 'etc.', ',', 'howev', ',', ""'s"", 'trade', 'around', '$', '18', '-', '$', '20', 'level', 'bit', ',', 'seem', 'like', 'solid', 'support', 'level', '.', 'with', 'low', 'pe', 'ratio', ',', 'seem', 'like', 'good', 'valu', 'pick', 'hold', ',', 'hope', 'ralli', '.', 'opinion', '?']",[8 2 0 ... 0 0 0],5
227,8,Santelli: 'I Don't Look at Gold as Gold Anymore',14,6,3,,"['santelli', ':', ""'"", 'i', 'do', ""n't"", 'look', 'gold', 'gold', ""anymore'"", 'nan']",[0 0 0 ... 0 0 0],10
851,3,BATS Global Markets has alerted traders that its systems have executed hundreds of thousands of transactions that may have violated securities rules,3,0,0,,"['bat', 'global', 'market', 'alert', 'trader', 'system', 'execut', 'hundr', 'thousand', 'transact', 'may', 'violat', 'secur', 'rule', 'nan']",[0 0 0 ... 0 0 0],5
332,8,NBG (1.60) Fun gamble or terrible decision?,9,1,9,What the title says. Shall I spice things up with an ultracontrarian gamble on the Greek banks? ,"['nbg', '(', '1.60', ')', 'fun', 'gambl', 'terribl', 'decis', '?', 'what', 'titl', 'say', '.', 'shall', 'i', 'spice', 'thing', 'ultracontrarian', 'gambl', 'greek', 'bank', '?']",[0 1 0 ... 0 0 0],10
792,4,Wall Street Journal turning into a bear?,4,0,1,,"['wall', 'street', 'journal', 'turn', 'bear', '?', 'nan']",[0 0 0 ... 0 0 0],5
507,5,Mark's Weekly Trading Log (4/15-4/19) Charts and Analysis,8,3,11,,"['mark', ""'s"", 'weekli', 'trade', 'log', '(', '4/15-4/19', ')', 'chart', 'analysi', 'nan']",[0 0 0 ... 0 0 0],5
382,6,Mark's Weekly Trading Log (5/27-5/31) Charts and Analysis--Month End Edition,6,0,0,,"['mark', ""'s"", 'weekli', 'trade', 'log', '(', '5/27-5/31', ')', 'chart', 'analysi', '--', 'month', 'end', 'edit', 'nan']",[0 0 0 ... 0 0 0],5
423,6,"Forget About QE3, the Slowdown’s Everywhere",9,3,0,,"['forget', 'about', 'qe3', ',', 'slowdown', '’', 'everywher', 'nan']",[1 0 0 ... 0 0 0],5
643,5,FB +20% on better than expected earnings,5,0,0,"Analysts cite compelling valuation and good growth coming.

Facebook ad platform said to be a very overlooked asset.
","['fb', '+20', '%', 'better', 'expect', 'earn', 'analyst', 'cite', 'compel', 'valuat', 'good', 'growth', 'come', '.', 'facebook', 'ad', 'platform', 'said', 'overlook', 'asset', '.']",[0 2 0 ... 0 0 0],5
973,3,Zynga Launches Own Space For Games Without Facebook,3,0,2,,"['zynga', 'launch', 'own', 'space', 'for', 'game', 'without', 'facebook', 'nan']",[0 0 0 ... 0 0 0],5
422,4,"Tip Of The Day! ""Escalation of Commitment""",7,3,8,"Escalation of commitment – “the phenomenon where people justify increased investment in a decision, based on the cumulative prior investment, despite new evidence suggesting that the cost, starting today, of continuing the decision outweighs the expected benefit.”

Keep this phrase at the front of your brain when you are in a position to make a decision regarding new trades.  Don't feel you should hold on to a sinking investment *just* because you have invested a lot of time, money, or energy into the stock.  Keep your head up!

Good luck ladies and gents.","['tip', 'of', 'the', 'day', '!', '``', 'escal', 'commit', ""''"", 'escal', 'commit', '–', '“', 'phenomenon', 'peopl', 'justifi', 'increas', 'invest', 'decis', ',', 'base', 'cumul', 'prior', 'invest', ',', 'despit', 'new', 'evid', 'suggest', 'cost', ',', 'start', 'today', ',', 'continu', 'decis', 'outweigh', 'expect', 'benefit.', '”', 'keep', 'phrase', 'front', 'brain', 'posit', 'make', 'decis', 'regard', 'new', 'trade', '.', 'do', ""n't"", 'feel', 'hold', 'sink', 'invest', '*', '*', 'invest', 'lot', 'time', ',', 'money', ',', 'energi', 'stock', '.', 'keep', 'head', '!', 'good', 'luck', 'ladi', 'gent', '.']",[6 3 0 ... 0 0 0],5
7,27,Caterpillar Just Downgraded The Whole World,36,9,7,,"['caterpillar', 'just', 'downgrad', 'the', 'whole', 'world', 'nan']",[0 0 0 ... 0 0 0],25
155,9,S&amp;P should find some short term support here 1365-70,10,1,9,"Im thinking we find some short term support here, but we test lower into the beginning of next week around 1350.

From there, depending what kind of numbers come out and the European mess, I think this market still has a chance at higher levels one more time before a bigger longer term sell off kicks in.

http://finviz.com/quote.ashx?t=spy","['s', '&', 'amp', ';', 'p', 'find', 'short', 'term', 'support', '1365-70', 'im', 'think', 'find', 'short', 'term', 'support', ',', 'test', 'lower', 'begin', 'next', 'week', 'around', '1350', '.', 'from', ',', 'depend', 'kind', 'number', 'come', 'european', 'mess', ',', 'i', 'think', 'market', 'still', 'chanc', 'higher', 'level', 'one', 'time', 'bigger', 'longer', 'term', 'sell', 'kick', '.', 'http', ':', '//finviz.com/quote.ashx', '?', 't=spi']",[3 2 0 ... 0 0 0],10
538,5,Mark's Weekly Log; Charts and Analysis.,5,0,4,,"['mark', ""'s"", 'weekli', 'log', ';', 'chart', 'analysi', '.', 'nan']",[0 1 0 ... 0 0 0],5
521,5,When your speculative derivative positions go massively wrong...,7,2,2,,"['when', 'specul', 'deriv', 'posit', 'go', 'massiv', 'wrong', '...', 'nan']",[0 0 0 ... 0 0 0],5
522,5,"I want to start trading stocks, but I have no idea how to pick them",6,1,12,"I'm 19 and have had an interest in trading stock for a while. I have read a few random books on stock trading as well as a few of the ""Rich Dad, Poor Dad"" series. From these books I've learned a lot about the general idea of investing, as well as some rules I should go by. Last year I got a schwab account and invested about $2,000 in Ford. A few months later, I made a few hundred dollars and now the money is just sitting in the account.

My uncle told me to invest in Ford because somebody told him to. At this point I have no idea where to put my money and I have no idea what kind of research I should be doing on companies. I'm looking to invest for about a year in a stock. If anybody can point me in the right direction as to where to start looking it would be greatly appreciated.

Thanks!","['i', 'want', 'start', 'trade', 'stock', ',', 'i', 'idea', 'pick', 'i', ""'m"", '19', 'interest', 'trade', 'stock', '.', 'i', 'read', 'random', 'book', 'stock', 'trade', 'well', '``', 'rich', 'dad', ',', 'poor', 'dad', ""''"", 'seri', '.', 'from', 'book', 'i', ""'ve"", 'learn', 'lot', 'gener', 'idea', 'invest', ',', 'well', 'rule', 'i', 'go', '.', 'last', 'year', 'i', 'got', 'schwab', 'account', 'invest', '$', '2,000', 'ford', '.', 'a', 'month', 'later', ',', 'i', 'made', 'hundr', 'dollar', 'money', 'sit', 'account', '.', 'my', 'uncl', 'told', 'invest', 'ford', 'somebodi', 'told', '.', 'at', 'point', 'i', 'idea', 'put', 'money', 'i', 'idea', 'kind', 'research', 'i', 'compani', '.', 'i', ""'m"", 'look', 'invest', 'year', 'stock', '.', 'if', 'anybodi', 'point', 'right', 'direct', 'start', 'look', 'would', 'greatli', 'appreci', '.', 'thank', '!']",[4 9 0 ... 0 0 0],5
388,5,YELP +20% pop here. Do you ever use Yelp?,11,6,27,"$2B in market cap and firing on all cylinders today with a 20% pop. I have never even visited their website, nor has anybody I know. 

&gt;YELP -- which has gained more than 34% year-to-date and is perched at $25.30 -- was also in the bullish spotlight this morning, after posting well-received earnings results and guidance yesterday. Northland upgraded the equity to ""market perform"" from ""underperform,"" while Macquarie, Oppenheimer, Jefferies, and RBC raised their price targets. Elsewhere, data from the International Securities Exchange (ISE), Chicago Board Options Exchange (CBOE), and NASDAQ OMX PHLX (PHLX) shows a 20-day call/put volume ratio of 4.36 for Yelp, Inc, indicating calls bought to open have more than quadrupled puts during the past month.

- schaeffersresearch.com","['yelp', '+20', '%', 'pop', '.', 'do', 'ever', 'use', 'yelp', '?', '$', '2b', 'market', 'cap', 'fire', 'cylind', 'today', '20', '%', 'pop', '.', 'i', 'never', 'even', 'visit', 'websit', ',', 'anybodi', 'i', 'know', '.', '&', 'gt', ';', 'yelp', '--', 'gain', '34', '%', 'year-to-d', 'perch', '$', '25.30', '--', 'also', 'bullish', 'spotlight', 'morn', ',', 'post', 'well-receiv', 'earn', 'result', 'guidanc', 'yesterday', '.', 'northland', 'upgrad', 'equiti', '``', 'market', 'perform', ""''"", '``', 'underperform', ',', ""''"", 'macquari', ',', 'oppenheim', ',', 'jefferi', ',', 'rbc', 'rais', 'price', 'target', '.', 'elsewher', ',', 'data', 'intern', 'secur', 'exchang', '(', 'ise', ')', ',', 'chicago', 'board', 'option', 'exchang', '(', 'cboe', ')', ',', 'nasdaq', 'omx', 'phlx', '(', 'phlx', ')', 'show', '20-day', 'call/put', 'volum', 'ratio', '4.36', 'yelp', ',', 'inc', ',', 'indic', 'call', 'bought', 'open', 'quadrupl', 'put', 'past', 'month', '.', '-', 'schaeffersresearch.com']",[11  6  0 ...  0  0  0],5
774,3,SWHC  +12% buy all the guns!,5,2,7,"This was a $3 stock in December! Is everybody buying more guns?

http://finviz.com/quote.ashx?t=swhc","['swhc', '+12', '%', 'buy', 'gun', '!', 'thi', '$', '3', 'stock', 'decemb', '!', 'is', 'everybodi', 'buy', 'gun', '?', 'http', ':', '//finviz.com/quote.ashx', '?', 't=swhc']",[0 0 0 ... 0 0 0],5
753,3,Legal Zoom IPO,5,2,7,"http://techcrunch.com/2012/05/11/legalzoom-ipo/

I'm a little late on the post. I feel like this is a real winner. Imagine in a few years what could happen. It's so much easier to go online than to your lawyer for these documents.

What do you guys think?

We still have a while, but I'm really a fan of this ""online-law"" industry. Legal Zoom just happens to be the biggest name with the most revenue thus far. ","['legal', 'zoom', 'ipo', 'http', ':', '//techcrunch.com/2012/05/11/legalzoom-ipo/', 'i', ""'m"", 'littl', 'late', 'post', '.', 'i', 'feel', 'like', 'real', 'winner', '.', 'imagin', 'year', 'could', 'happen', '.', 'it', ""'s"", 'much', 'easier', 'go', 'onlin', 'lawyer', 'document', '.', 'what', 'guy', 'think', '?', 'we', 'still', ',', 'i', ""'m"", 'realli', 'fan', '``', 'online-law', ""''"", 'industri', '.', 'legal', 'zoom', 'happen', 'biggest', 'name', 'revenu', 'thu', 'far', '.']",[1 6 0 ... 0 0 0],5
327,6,$WDC Long Scalp ,9,3,19,,"['$', 'wdc', 'long', 'scalp', 'nan']",[0 0 0 ... 0 0 0],5
824,2,SPY channel? Is this going to be the play for today?,5,3,3,,"['spi', 'channel', '?', 'is', 'go', 'play', 'today', '?', 'nan']",[0 0 0 ... 0 0 0],0
929,2,All these graphs and projections. ,5,3,6,I just wonder how people come up with these crazy shape predictions. I mean the market is mostly moved my news and general attitude by the people right. How can someone look at a stocks graph for the last week or whatever and randomly predict it's gonna go one way or the other? Are there typical shapes? ,"['all', 'graph', 'project', '.', 'i', 'wonder', 'peopl', 'come', 'crazi', 'shape', 'predict', '.', 'i', 'mean', 'market', 'mostli', 'move', 'news', 'gener', 'attitud', 'peopl', 'right', '.', 'how', 'someon', 'look', 'stock', 'graph', 'last', 'week', 'whatev', 'randomli', 'predict', ""'s"", 'gon', 'na', 'go', 'one', 'way', '?', 'are', 'typic', 'shape', '?']",[0 3 0 ... 0 0 0],0
543,4,Nasdaq falls 2 percent on profit concerns ,5,1,7,,"['nasdaq', 'fall', '2', 'percent', 'profit', 'concern', 'nan']",[0 0 0 ... 0 0 0],5
527,5,Debunking The Myth: The Demise Of The U.S. Dollar,8,3,1,,"['debunk', 'the', 'myth', ':', 'the', 'demis', 'of', 'the', 'u.s.', 'dollar', 'nan']",[0 0 0 ... 0 0 0],5
578,5,Stocks Rally at Open; Banks Take Lead ,7,2,2,,"['stock', 'ralli', 'open', ';', 'bank', 'take', 'lead', 'nan']",[0 0 0 ... 0 0 0],5
703,4,COH -16% Coach U.S. Sales Disappoint ,4,0,0,,"['coh', '-16', '%', 'coach', 'u.', '.', 'sale', 'disappoint', 'nan']",[0 1 0 ... 0 0 0],5
439,5,$LVS: Didn't have time earleir to post this one guys.  Performing well.,7,2,5,,"['$', 'lv', ':', 'did', ""n't"", 'time', 'earleir', 'post', 'one', 'guy', '.', 'perform', 'well', '.', 'nan']",[0 2 0 ... 0 0 0],5
968,3,CCI - Crown Castle Int. added to S&amp;P 500,3,0,2,"WSJ - Standard &amp; Poor’s Wednesday said it will add telecommunications company Crown Castle International Corp. to its S&amp;P 500 index, replacing Constellation Energy Group Inc. after Exelon Corp. completes its expected merger with the utility company.  Crown Castle shares rose 3.6% to $54.50 premarket and Constellation Energy Group’s stock added 1% to $35.86. The shares of companies joining the S&amp;P 500 often rise because many portfolio managers try to track the index.

http://finviz.com/quote.ashx?t=cci","['cci', '-', 'crown', 'castl', 'int', '.', 'ad', 's', '&', 'amp', ';', 'p', '500', 'wsj', '-', 'standard', '&', 'amp', ';', 'poor', '’', 'wednesday', 'said', 'add', 'telecommun', 'compani', 'crown', 'castl', 'intern', 'corp.', 's', '&', 'amp', ';', 'p', '500', 'index', ',', 'replac', 'constel', 'energi', 'group', 'inc.', 'exelon', 'corp.', 'complet', 'expect', 'merger', 'util', 'compani', '.', 'crown', 'castl', 'share', 'rose', '3.6', '%', '$', '54.50', 'premarket', 'constel', 'energi', 'group', '’', 'stock', 'ad', '1', '%', '$', '35.86', '.', 'the', 'share', 'compani', 'join', 's', '&', 'amp', ';', 'p', '500', 'often', 'rise', 'mani', 'portfolio', 'manag', 'tri', 'track', 'index', '.', 'http', ':', '//finviz.com/quote.ashx', '?', 't=cci']",[1 4 0 ... 0 0 0],5
228,9,Great Article on INVN- Basically outlining what is speculated to be a new AAPL supplier,9,0,5,"http://news.investors.com/business-the-new-america/021413-644499-invensense-motion-sensors-found-in-smartphones.htm?ven=yahoocp,yahoo","['great', 'articl', 'invn-', 'basic', 'outlin', 'specul', 'new', 'aapl', 'supplier', 'http', ':', '//news.investors.com/business-the-new-america/021413-644499-invensense-motion-sensors-found-in-smartphones.htm', '?', 'ven=yahoocp', ',', 'yahoo']",[1 0 0 ... 0 0 0],10
344,7,Biggest % movers Mon 7th,7,0,1,"Heading into the lunch hour, the following stocks are showing the biggest % gains:

INSM	Insmed, Inc.	4.76	76.30%

GTSI	GTSI Corp	7.71	47.14%

VRTX	Vertex Pharmaceuticals	54.27	45.07%

CLIR	ClearSign Combustion Corp 	9.00	20.97%

SYNC	SYNC	12.88	13.08%

GEO	The GEO Group Inc	22.16	7.94%

AHS	AMN Healthcare Svcs	7.37	7.36%

KT	KT Corp (Korea)	13.41	7.02%

INDL	Direxion Daily India Bull 3X	18.45	6.77%

KGJI	Kingold Jewelry Inc	2.34	6.36%

","['biggest', '%', 'mover', 'mon', '7th', 'head', 'lunch', 'hour', ',', 'follow', 'stock', 'show', 'biggest', '%', 'gain', ':', 'insm', 'insm', ',', 'inc.', '4.76', '76.30', '%', 'gtsi', 'gtsi', 'corp', '7.71', '47.14', '%', 'vrtx', 'vertex', 'pharmaceut', '54.27', '45.07', '%', 'clir', 'clearsign', 'combust', 'corp', '9.00', '20.97', '%', 'sync', 'sync', '12.88', '13.08', '%', 'geo', 'the', 'geo', 'group', 'inc', '22.16', '7.94', '%', 'ah', 'amn', 'healthcar', 'svc', '7.37', '7.36', '%', 'kt', 'kt', 'corp', '(', 'korea', ')', '13.41', '7.02', '%', 'indl', 'direxion', 'daili', 'india', 'bull', '3x', '18.45', '6.77', '%', 'kgji', 'kingold', 'jewelri', 'inc', '2.34', '6.36', '%']",[2 0 0 ... 0 0 0],5
887,3,"Sept 7th Stocks to Watch: Pandora, Smith &amp; Wesson, Audience",5,2,4,,"['sept', '7th', 'stock', 'watch', ':', 'pandora', ',', 'smith', '&', 'amp', ';', 'wesson', ',', 'audienc', 'nan']",[2 0 0 ... 0 0 0],5
212,11,Opening Day Range Day Trading Strategy Explained.,11,0,18,,"['open', 'day', 'rang', 'day', 'trade', 'strategi', 'explain', '.', 'nan']",[0 1 0 ... 0 0 0],10
79,13,Companies Exposed To Wal-Mart,15,2,1,,"['compani', 'expos', 'to', 'wal-mart', 'nan']",[0 0 0 ... 0 0 0],15
148,8,Week Ahead: No News May Be Good News for Stocks,10,2,0,,"['week', 'ahead', ':', 'no', 'new', 'may', 'be', 'good', 'new', 'stock', 'nan']",[0 0 0 ... 0 0 0],10
302,4,"5 Things to Watch This Week: Disney, Dividends, Pandora, Big Lots and Wii",6,2,5,"Internet radio giant Pandora and giant discounter Big Lots report their earnings; in entertainment, Disney is opening a huge new expansion, while Nintendo is thinking small; and some companies just can give money away fast enough -- as dividends. Read more

Source:- http://www.dailyfinance.com/2012/12/03/wall-street-disney-dividends-pandora-big-lots-wii-mini/","['5', 'thing', 'watch', 'thi', 'week', ':', 'disney', ',', 'dividend', ',', 'pandora', ',', 'big', 'lot', 'wii', 'internet', 'radio', 'giant', 'pandora', 'giant', 'discount', 'big', 'lot', 'report', 'earn', ';', 'entertain', ',', 'disney', 'open', 'huge', 'new', 'expans', ',', 'nintendo', 'think', 'small', ';', 'compani', 'give', 'money', 'away', 'fast', 'enough', '--', 'dividend', '.', 'read', 'sourc', ':', '-', 'http', ':', '//www.dailyfinance.com/2012/12/03/wall-street-disney-dividends-pandora-big-lots-wii-mini/']",[5 1 0 ... 0 0 0],5
328,7,Health-Care Overhaul Upheld By U.S. Supreme Court. Hospital stocks soaring.,7,0,5,"http://www.bloomberg.com/news/2012-06-28/obama-s-health-care-overhaul-upheld-by-u-s-supreme-court.html

Hospital stocks rocking! 

Obama care means more people going to hospitals because your $1000 trip to the ER for a headache is now covered by tax payers.

Big movers: 

http://finviz.com/quote.ashx?t=thc

http://finviz.com/quote.ashx?t=hca

http://finviz.com/quote.ashx?t=uhs

http://finviz.com/quote.ashx?t=cyh
","['health-car', 'overhaul', 'upheld', 'by', 'u.s.', 'suprem', 'court', '.', 'hospit', 'stock', 'soar', '.', 'http', ':', '//www.bloomberg.com/news/2012-06-28/obama-s-health-care-overhaul-upheld-by-u-s-supreme-court.html', 'hospit', 'stock', 'rock', '!', 'obama', 'care', 'mean', 'peopl', 'go', 'hospit', '$', '1000', 'trip', 'er', 'headach', 'cover', 'tax', 'payer', '.', 'big', 'mover', ':', 'http', ':', '//finviz.com/quote.ashx', '?', 't=thc', 'http', ':', '//finviz.com/quote.ashx', '?', 't=hca', 'http', ':', '//finviz.com/quote.ashx', '?', 't=uh', 'http', ':', '//finviz.com/quote.ashx', '?', 't=cyh']",[0 3 0 ... 0 0 0],5
319,8,Game Plan for 7/20,8,0,12,"Looking for long SNDK for the gapfill at 40.
Chart: http://imgur.com/3P7pN

IR below 41 should get down to 40/39.65
Chart: http://imgur.com/kkbNc

SXC breakout above 15.20ish
http://finviz.com/quote.ashx?t=sxc&amp;ty=c&amp;ta=1&amp;p=d

Other stocks on my watchlist: AMD,BHI,GE,MAN,MSFT

Just a quick disclaimer- I'm a day trader so I'm flexible to trade any of these setups either way.


EDIT: Short AMD, out 71c

EDIT 2: Covered AMD at 4.29","['game', 'plan', '7/20', 'look', 'long', 'sndk', 'gapfil', '40', '.', 'chart', ':', 'http', ':', '//imgur.com/3p7pn', 'ir', '41', 'get', '40/39.65', 'chart', ':', 'http', ':', '//imgur.com/kkbnc', 'sxc', 'breakout', '15.20ish', 'http', ':', '//finviz.com/quote.ashx', '?', 't=sxc', '&', 'amp', ';', 'ty=c', '&', 'amp', ';', 'ta=1', '&', 'amp', ';', 'p=d', 'other', 'stock', 'watchlist', ':', 'amd', ',', 'bhi', ',', 'ge', ',', 'man', ',', 'msft', 'just', 'quick', 'disclaimer-', 'i', ""'m"", 'day', 'trader', 'i', ""'m"", 'flexibl', 'trade', 'setup', 'either', 'way', '.', 'edit', ':', 'short', 'amd', ',', '71c', 'edit', '2', ':', 'cover', 'amd', '4.29']",[5 2 0 ... 0 0 0],10
497,4,"If the Elliott guys are right, then we have more downside coming",6,2,6,,"['if', 'elliott', 'guy', 'right', ',', 'downsid', 'come', 'nan']",[1 0 0 ... 0 0 0],5
660,4,How to use bond yields to assess the value of stocks | Investing,5,1,0,,"['how', 'use', 'bond', 'yield', 'assess', 'valu', 'stock', '|', 'invest', 'nan']",[0 0 0 ... 0 0 0],5
584,5,Stock Market Today: June 14th biggest % movers,5,0,8,"Nat gas making some moves here, the BOIL ETF is tracking that. Another solar making some moves along with the rest of the top 10 movers as of 11am:

NBG	National Bank Of Greece ADS	1.61	30.89%

BSPM	Biostar Pharmaceuticals Inc	1.80	22.45%

JASO	JA Solar Holdings Co Ltd	1.13	21.49%

GMO	Idaho General Mines Inc	3.14	15.56%

BOIL	ProShares Ultra Natural Gas	34.87	14.03%

JIVE	Jive Software Inc	18.49	10.52%

GFA	GAFISA SA	2.91	10.23%

QSFT	Quest Software	26.18	9.72%

IGT	Intl Game Technology	14.50	9.68%

SMBL	Smart Balance Inc	7.90	8.37%
","['stock', 'market', 'today', ':', 'june', '14th', 'biggest', '%', 'mover', 'nat', 'ga', 'make', 'move', ',', 'boil', 'etf', 'track', '.', 'anoth', 'solar', 'make', 'move', 'along', 'rest', 'top', '10', 'mover', '11am', ':', 'nbg', 'nation', 'bank', 'of', 'greec', 'ad', '1.61', '30.89', '%', 'bspm', 'biostar', 'pharmaceut', 'inc', '1.80', '22.45', '%', 'jaso', 'ja', 'solar', 'hold', 'co', 'ltd', '1.13', '21.49', '%', 'gmo', 'idaho', 'gener', 'mine', 'inc', '3.14', '15.56', '%', 'boil', 'proshar', 'ultra', 'natur', 'ga', '34.87', '14.03', '%', 'jive', 'jive', 'softwar', 'inc', '18.49', '10.52', '%', 'gfa', 'gafisa', 'sa', '2.91', '10.23', '%', 'qsft', 'quest', 'softwar', '26.18', '9.72', '%', 'igt', 'intl', 'game', 'technolog', '14.50', '9.68', '%', 'smbl', 'smart', 'balanc', 'inc', '7.90', '8.37', '%']",[1 1 0 ... 0 0 0],5
741,3,I'm not very good at technical analysis yet.. But what do you guys think about fossil (FOSL)? ,6,3,3,Feel free to chart it yourselves and post it here. Let me know what you are thinking.,"['i', ""'m"", 'good', 'technic', 'analysi', 'yet', '..', 'but', 'guy', 'think', 'fossil', '(', 'fosl', ')', '?', 'feel', 'free', 'chart', 'post', '.', 'let', 'know', 'think', '.']",[0 2 0 ... 0 0 0],5
133,9,"MOMOtrader and others, whats your plan for tomorrows FED?",11,2,96,"I think we all know there will be a whipsaw.

Will it be big down then up for the day?

Or big rip up only to be faded lower and the downtrend will continue?

Whats your best guess and why?","['momotrad', 'other', ',', 'what', 'plan', 'tomorrow', 'fed', '?', 'i', 'think', 'know', 'whipsaw', '.', 'will', 'big', 'day', '?', 'or', 'big', 'rip', 'fade', 'lower', 'downtrend', 'continu', '?', 'what', 'best', 'guess', '?']",[1 1 0 ... 0 0 0],10
547,4,Stock Market Analysis For Week Ending 9/28/12,6,2,1,,"['stock', 'market', 'analysi', 'for', 'week', 'end', '9/28/12', 'nan']",[0 0 0 ... 0 0 0],5
311,8,Consumer Confidence in U.S. Increases to a Seven-Month High,9,1,1,,"['consum', 'confid', 'u.s.', 'increas', 'seven-month', 'high', 'nan']",[0 0 0 ... 0 0 0],10
603,5,Ran across this when I was bored in class this morning,7,2,0,,"['ran', 'across', 'i', 'bore', 'class', 'morn', 'nan']",[0 0 0 ... 0 0 0],5
432,5,JPM Short with Fibonacci Arcs,8,3,1,,"['jpm', 'short', 'fibonacci', 'arc', 'nan']",[0 0 0 ... 0 0 0],5
0,62,"I am a professional, self-employed trader. AMAA.",79,17,139,Per request.  Please understand I can only answer so much right now due to legal reasons.,"['i', 'profession', ',', 'self-employ', 'trader', '.', 'amaa', '.', 'per', 'request', '.', 'pleas', 'understand', 'i', 'answer', 'much', 'right', 'due', 'legal', 'reason', '.']",[1 4 1 ... 0 0 0],60
316,7,I need help understanding a concept in Murphy's Technical Analysis of the Financial Markets: how can prices react to unknown fundamentals?,7,0,11,"The text states that ""market price tends to lead the known fundamentals,"" or ""market price acts as a leading indicator of the fundamentals."" In other words, ""while the known fundamentals have already been discounted and are already 'in the market,' prices are now reacting to the unknown fundamentals.""

My question has to do with the last sentence: how can prices react to something unknown? Thanks for any help for an up-and-coming technician.","['i', 'need', 'help', 'understand', 'concept', 'murphi', ""'s"", 'technic', 'analysi', 'financi', 'market', ':', 'price', 'react', 'unknown', 'fundament', '?', 'the', 'text', 'state', '``', 'market', 'price', 'tend', 'lead', 'known', 'fundament', ',', ""''"", '``', 'market', 'price', 'act', 'lead', 'indic', 'fundament', '.', ""''"", 'in', 'word', ',', '``', 'known', 'fundament', 'alreadi', 'discount', 'alreadi', ""'in"", 'market', ',', ""'"", 'price', 'react', 'unknown', 'fundament', '.', ""''"", 'my', 'question', 'last', 'sentenc', ':', 'price', 'react', 'someth', 'unknown', '?', 'thank', 'help', 'up-and-com', 'technician', '.']",[3 3 0 ... 0 0 0],5
903,2,Another QQQ successful scalp filed away.,5,3,5,"Notice how you can have confidence in predictability in setups similar to this.  The market gives respect to these support and resistance levels. 

https://www.tradingview.com/v/NFi4ArzL","['anoth', 'qqq', 'success', 'scalp', 'file', 'away', '.', 'notic', 'confid', 'predict', 'setup', 'similar', '.', 'the', 'market', 'give', 'respect', 'support', 'resist', 'level', '.', 'http', ':', '//www.tradingview.com/v/nfi4arzl']",[0 3 0 ... 0 0 0],0
544,5,"If market makers are the ones who move prices, how can you profit?",5,0,15,"Obviously there are many individuals who profit, but I'm just theorycrafting here and I'm a bit lost on this. Market makers see more than we do, which shares are individual vs institutional and they, ultimately, can push their agenda with their large capital.

So is the (short/med-term) game to outsmart the market makers? They're there to make sure there's liquidity and also to profit: buy high, sell higher because of individuals helping drive the price up with them; or, sell massively and buy lower.

Perhaps I'm off on this, can someone help me out here to understand this?","['if', 'market', 'maker', 'one', 'move', 'price', ',', 'profit', '?', 'obvious', 'mani', 'individu', 'profit', ',', 'i', ""'m"", 'theorycraft', 'i', ""'m"", 'bit', 'lost', '.', 'market', 'maker', 'see', ',', 'share', 'individu', 'vs', 'institut', ',', 'ultim', ',', 'push', 'agenda', 'larg', 'capit', '.', 'so', '(', 'short/med-term', ')', 'game', 'outsmart', 'market', 'maker', '?', 'they', ""'re"", 'make', 'sure', ""'s"", 'liquid', 'also', 'profit', ':', 'buy', 'high', ',', 'sell', 'higher', 'individu', 'help', 'drive', 'price', ';', ',', 'sell', 'massiv', 'buy', 'lower', '.', 'perhap', 'i', ""'m"", ',', 'someon', 'help', 'understand', '?']",[8 3 0 ... 0 0 0],5
465,6,"[BBY] missed earnings, closing down 50 stores.  Down 9.3% as of 11:30 ET",6,0,5,"When it retraced a little bit, I jumped on some high delta puts, I'm up nicely on them, we're trading near what I believe is likely the bottom for today, would you take profits now, or slap a stop on it and hope it drops more in the next several days?  Looking at the previous December drop, it fell for 5 days straight.

http://stockcharts.com/h-sc/ui?s=BBY&amp;p=D&amp;b=6&amp;g=0&amp;id=p62289419128","['[', 'bbi', ']', 'miss', 'earn', ',', 'close', '50', 'store', '.', 'down', '9.3', '%', '11:30', 'et', 'when', 'retrac', 'littl', 'bit', ',', 'i', 'jump', 'high', 'delta', 'put', ',', 'i', ""'m"", 'nice', ',', ""'re"", 'trade', 'near', 'i', 'believ', 'like', 'bottom', 'today', ',', 'would', 'take', 'profit', ',', 'slap', 'stop', 'hope', 'drop', 'next', 'sever', 'day', '?', 'look', 'previou', 'decemb', 'drop', ',', 'fell', '5', 'day', 'straight', '.', 'http', ':', '//stockcharts.com/h-sc/ui', '?', 's=bbi', '&', 'amp', ';', 'p=d', '&', 'amp', ';', 'b=6', '&', 'amp', ';', 'g=0', '&', 'amp', ';', 'id=p62289419128']",[7 2 0 ... 0 0 0],5
529,7,I can only afford 3 shares of Google. Is it worth it?,10,3,11,,"['i', 'afford', '3', 'share', 'googl', '.', 'is', 'worth', '?', 'nan']",[0 1 0 ... 0 0 0],5
468,6,"Great trading the last few days, is today the day small caps finally break out or will OPEX put it off until next week?",8,2,3,,"['great', 'trade', 'last', 'day', ',', 'today', 'day', 'small', 'cap', 'final', 'break', 'opex', 'put', 'next', 'week', '?', 'nan']",[1 0 0 ... 0 0 0],5
734,5,"June 20 Stocks to Watch: ConAgra Foods, GNC Holdings, Jabil Circuit",6,1,0,,"['june', '20', 'stock', 'watch', ':', 'conagra', 'food', ',', 'gnc', 'hold', ',', 'jabil', 'circuit', 'nan']",[2 0 0 ... 0 0 0],5
172,8,Asian Stocks Gain as Slow U.S. Growth Lifts Stimulus Bets - Funny bad news is good news now,9,1,2,,"['asian', 'stock', 'gain', 'slow', 'u.s.', 'growth', 'lift', 'stimulu', 'bet', '-', 'funni', 'bad', 'news', 'good', 'news', 'nan']",[0 0 0 ... 0 0 0],10
125,11,"Zynga CEO Mark Pincus on CNBC, I almost felt bad for him.",12,1,12,"Anybody catch him on air just now?  Poor guy, I wouldn't wish it upon my worst enemies to try and justify Zynga's value.  I almost felt bad for him there.","['zynga', 'ceo', 'mark', 'pincu', 'cnbc', ',', 'i', 'almost', 'felt', 'bad', '.', 'anybodi', 'catch', 'air', '?', 'poor', 'guy', ',', 'i', 'would', ""n't"", 'wish', 'upon', 'worst', 'enemi', 'tri', 'justifi', 'zynga', ""'s"", 'valu', '.', 'i', 'almost', 'felt', 'bad', '.']",[2 3 0 ... 0 0 0],10
749,4,"Everybody that got into those AAPL calls, consider locking some up here +100%",6,2,5,"Hi guys

Im away from the computer so I cant check in too often, but to any of you that got into those AAPL calls around $5, be sure to take some off the table here, its currently around $10 so thats a +100% gain which is a nice present to yourself.

This could have more to go, but you will never go broke taking a profit!
","['everybodi', 'got', 'aapl', 'call', ',', 'consid', 'lock', '+100', '%', 'hi', 'guy', 'im', 'away', 'comput', 'i', 'cant', 'check', 'often', ',', 'got', 'aapl', 'call', 'around', '$', '5', ',', 'sure', 'take', 'tabl', ',', 'current', 'around', '$', '10', 'that', '+100', '%', 'gain', 'nice', 'present', '.', 'thi', 'could', 'go', ',', 'never', 'go', 'broke', 'take', 'profit', '!']",[5 1 0 ... 0 0 0],5
411,5,"Verizon coming down to 200dma, dividend nearing 5%",6,1,10,,"['verizon', 'come', '200dma', ',', 'dividend', 'near', '5', '%', 'nan']",[1 0 0 ... 0 0 0],5
898,4,"New to stocks, big risk to short BestBuy?",5,1,16,"I am new to owning stocks but I have around 10k to invest.  I have been seeing lots of negative news relating to BestBuy and their business strategy.  I feel like they will be the next large retailer to go down, is it smart to go short?  I am not sure the best way about this.","['new', 'stock', ',', 'big', 'risk', 'short', 'bestbuy', '?', 'i', 'new', 'own', 'stock', 'i', 'around', '10k', 'invest', '.', 'i', 'see', 'lot', 'neg', 'news', 'relat', 'bestbuy', 'busi', 'strategi', '.', 'i', 'feel', 'like', 'next', 'larg', 'retail', 'go', ',', 'smart', 'go', 'short', '?', 'i', 'sure', 'best', 'way', '.']",[2 3 0 ... 0 0 0],5
90,11,Wall street Survivor; Great Resource for Beginning Stock Investors!,16,5,4,,"['wall', 'street', 'survivor', ';', 'great', 'resourc', 'begin', 'stock', 'investor', '!', 'nan']",[0 0 0 ... 0 0 0],10
934,3,Geithner to the Rescue? Spain's deputy prime minister Soraya Saenz de Santamaria held talks with US Treasury Secretary Timothy Geithner and IMF director general Christine Lagarde,5,2,0,,"['geithner', 'rescu', '?', 'spain', ""'s"", 'deputi', 'prime', 'minist', 'soraya', 'saenz', 'de', 'santamaria', 'held', 'talk', 'us', 'treasuri', 'secretari', 'timothi', 'geithner', 'imf', 'director', 'gener', 'christin', 'lagard', 'nan']",[0 0 0 ... 0 0 0],5
181,9,Cyprus Edges Closer to a European Union Bailout,9,0,2,,"['cypru', 'edg', 'closer', 'european', 'union', 'bailout', 'nan']",[0 0 0 ... 0 0 0],10
274,8,SP kiss of death?,9,1,10,,"['sp', 'kiss', 'death', '?', 'nan']",[0 0 0 ... 0 0 0],10
890,3,Stock Trader's Almanac (Live Cattle Strength) 14 AUG.,3,0,0,,"['stock', 'trader', ""'s"", 'almanac', '(', 'live', 'cattl', 'strength', ')', '14', 'aug.', 'nan']",[0 0 0 ... 0 0 0],5
69,14,"Starting Monday, I will be undertaking a $2000 options challenge against myself.  My first goal will be $10K.  I will live stream trades when possible.",18,4,17,"You will be able to follow along with all of my trades at my website: www.infinitemargin.com

I have just funded a separate thinkorswim account and will be using Profitly to verify trades.  I will be working on the site getting all the appropriate links in place.

This is something I've been wanting to do for a while, please do not confuse this as an attempt to promote options trading.  I am not responsible for any trading loses you may incur if you to mimic my trades.  Don't be an idiot.

","['start', 'monday', ',', 'i', 'undertak', '$', '2000', 'option', 'challeng', '.', 'my', 'first', 'goal', '$', '10k', '.', 'i', 'live', 'stream', 'trade', 'possibl', '.', 'you', 'abl', 'follow', 'along', 'trade', 'websit', ':', 'www.infinitemargin.com', 'i', 'fund', 'separ', 'thinkorswim', 'account', 'use', 'profitli', 'verifi', 'trade', '.', 'i', 'work', 'site', 'get', 'appropri', 'link', 'place', '.', 'thi', 'someth', 'i', ""'ve"", 'want', ',', 'pleas', 'confus', 'attempt', 'promot', 'option', 'trade', '.', 'i', 'respons', 'trade', 'lose', 'may', 'incur', 'mimic', 'trade', '.', 'do', ""n't"", 'idiot', '.']",[2 8 0 ... 0 0 0],15
291,6,Brutally simple way to trade the news.. is it just me or is it flawed?,9,3,4,,"['brutal', 'simpl', 'way', 'trade', 'news', '..', 'flaw', '?', 'nan']",[0 0 0 ... 0 0 0],5
131,10,Backwardation in crude,14,4,7,,"['backward', 'crude', 'nan']",[0 0 0 ... 0 0 0],10
300,6,Quick News Overview?,7,1,7,"This may be a long shot, but I am in need.

I'm an option trader. My strategy trades individual companies as well as indices. For the companies, I generally do not place trades when there are earnings within my trade window, and try to stay away from companies when there are mergers or other big news events.

I'm looking for a site (paid or free) that can give a relatively uptodate and quick summary of the company and its news. I use yahoo and google news but they have so much crap to weed through on the big companies, but its slightly better than looking at the wire.

My wife suggested some kind of news-cloud that highlights the big ""items"" being talked about, but I can't find any site that does this.

Does anyone know of a place where I can get a quick run down of the big happenings for a company? ","['quick', 'new', 'overview', '?', 'thi', 'may', 'long', 'shot', ',', 'i', 'need', '.', 'i', ""'m"", 'option', 'trader', '.', 'my', 'strategi', 'trade', 'individu', 'compani', 'well', 'indic', '.', 'for', 'compani', ',', 'i', 'gener', 'place', 'trade', 'earn', 'within', 'trade', 'window', ',', 'tri', 'stay', 'away', 'compani', 'merger', 'big', 'news', 'event', '.', 'i', ""'m"", 'look', 'site', '(', 'paid', 'free', ')', 'give', 'rel', 'uptod', 'quick', 'summari', 'compani', 'news', '.', 'i', 'use', 'yahoo', 'googl', 'news', 'much', 'crap', 'weed', 'big', 'compani', ',', 'slightli', 'better', 'look', 'wire', '.', 'my', 'wife', 'suggest', 'kind', 'news-cloud', 'highlight', 'big', '``', 'item', ""''"", 'talk', ',', 'i', 'ca', ""n't"", 'find', 'site', '.', 'doe', 'anyon', 'know', 'place', 'i', 'get', 'quick', 'run', 'big', 'happen', 'compani', '?']",[5 7 0 ... 0 0 0],5
935,3,Biggest % movers May 31,5,2,1,"Into the first hour with the markets lower, inverse VIX ETFs are moving big time!

TLB	Talbots Inc	2.50	93.41%

MVIS(F)	Microvision Inc	2.62	37.17%

CFK	CE Franklin Ltd	12.23	34.84%

GIB	CGI Group	22.81	11.70%

IMUC	ImmunoCellular Therapeutics	3.58	9.15%

UVXY	ProShares Ultra VIX Short-Term	21.20	8.33%

TVIX	VS 2X VIX Short Term	9.52	8.18%

UBNT	Ubiquiti Networks Inc	18.34	7.63%

FLO	Flowers Foods	22.41	7.56%

CIEN	Ciena Corp	12.68	6.73%
","['biggest', '%', 'mover', 'may', '31', 'into', 'first', 'hour', 'market', 'lower', ',', 'invers', 'vix', 'etf', 'move', 'big', 'time', '!', 'tlb', 'talbot', 'inc', '2.50', '93.41', '%', 'mvi', '(', 'f', ')', 'microvis', 'inc', '2.62', '37.17', '%', 'cfk', 'ce', 'franklin', 'ltd', '12.23', '34.84', '%', 'gib', 'cgi', 'group', '22.81', '11.70', '%', 'imuc', 'immunocellular', 'therapeut', '3.58', '9.15', '%', 'uvxi', 'proshar', 'ultra', 'vix', 'short-term', '21.20', '8.33', '%', 'tvix', 'vs', '2x', 'vix', 'short', 'term', '9.52', '8.18', '%', 'ubnt', 'ubiqu', 'network', 'inc', '18.34', '7.63', '%', 'flo', 'flower', 'food', '22.41', '7.56', '%', 'cien', 'ciena', 'corp', '12.68', '6.73', '%']",[1 0 0 ... 0 0 0],5
326,5,Stock Ideas Weekend July 6th.  Let's see how wrong I am over next week.,11,6,6,,"['stock', 'idea', 'weekend', 'juli', '6th', '.', 'let', ""'s"", 'see', 'wrong', 'i', 'next', 'week', '.', 'nan']",[0 2 0 ... 0 0 0],5
144,10,Gold Loses QE3 Gains,11,1,3,,"['gold', 'lose', 'qe3', 'gain', 'nan']",[0 0 0 ... 0 0 0],10
694,5,Marco's Mid Week Chart Pattern and Analysis Update!,5,0,3,"For those that find chart patterns fun to analize.
http://www.hotstockmarket.com/t/179687/countdown-to-blastoff/120#post_2887394","['marco', ""'s"", 'mid', 'week', 'chart', 'pattern', 'analysi', 'updat', '!', 'for', 'find', 'chart', 'pattern', 'fun', 'anal', '.', 'http', ':', '//www.hotstockmarket.com/t/179687/countdown-to-blastoff/120', '#', 'post_2887394']",[0 1 0 ... 0 0 0],5
797,4,Hello AAPL $500,4,0,5,"AAPL about to hit the $500 mark.

Where is my ipad3?!","['hello', 'aapl', '$', '500', 'aapl', 'hit', '$', '500', 'mark', '.', 'where', 'ipad3', '?', '!']",[0 1 0 ... 0 0 0],5
135,9,"I made a Black-Scholes calculator, let me know what you think. (x-post r/finance)",13,4,5,,"['i', 'made', 'black-schol', 'calcul', ',', 'let', 'know', 'think', '.', '(', 'x-post', 'r/financ', ')', 'nan']",[1 1 0 ... 0 0 0],10
398,7,"HP forecast beats Street, CEO says overhaul taking hold",9,2,2,,"['hp', 'forecast', 'beat', 'street', ',', 'ceo', 'say', 'overhaul', 'take', 'hold', 'nan']",[1 0 0 ... 0 0 0],5
164,8,Live Day Trading chat with scanners and trade alerts in real time,13,5,13,"come check it out,  www.funky.omnovia.com

password is ""getfunky""

use your own email address.  thanks!!","['live', 'day', 'trade', 'chat', 'scanner', 'trade', 'alert', 'real', 'time', 'come', 'check', ',', 'www.funky.omnovia.com', 'password', '``', 'getfunki', ""''"", 'use', 'email', 'address', '.', 'thank', '!', '!']",[1 1 0 ... 0 0 0],10
28,17,S&amp;P futures hit 1685 and get smacked!,20,3,10,"Yes, its too early to call a top, but this is the first time we have seen such weak market internals shift sentiment from extreme bullish readings to extreme bearish within the same session.

A huge intraday range today and a very decent showing by the bears so far.

","['s', '&', 'amp', ';', 'p', 'futur', 'hit', '1685', 'get', 'smack', '!', 'ye', ',', 'earli', 'call', 'top', ',', 'first', 'time', 'seen', 'weak', 'market', 'intern', 'shift', 'sentiment', 'extrem', 'bullish', 'read', 'extrem', 'bearish', 'within', 'session', '.', 'a', 'huge', 'intraday', 'rang', 'today', 'decent', 'show', 'bear', 'far', '.']",[2 2 0 ... 0 0 0],15
559,4,For your learning pleasures: $QQQ: Scalping A Technical Breakout (Technical Analysis),5,1,12,,"['for', 'learn', 'pleasur', ':', '$', 'qqq', ':', 'scalp', 'a', 'technic', 'breakout', '(', 'technic', 'analysi', ')', 'nan']",[0 0 0 ... 0 0 0],5
193,9,Four Reasons Why The Fed Will Not Announce QE 3 This Friday,10,1,4,,"['four', 'reason', 'whi', 'the', 'fed', 'will', 'not', 'announc', 'qe', '3', 'thi', 'friday', 'nan']",[0 0 0 ... 0 0 0],10
380,6,Most shocking chart of the day! We have not had 3 consecutive down days all year!,9,3,4,,"['most', 'shock', 'chart', 'day', '!', 'we', '3', 'consecut', 'day', 'year', '!', 'nan']",[0 0 0 ... 0 0 0],5
634,4,S&amp;P Futures Trading Levels 08-02,5,1,2,,"['s', '&', 'amp', ';', 'p', 'futur', 'trade', 'level', '08-02', 'nan']",[0 0 0 ... 0 0 0],5
169,9,"UPS -5% premarket ""slowing US industrial economy""",12,3,5,"
    *UPS EXPECTS TO REPORT 2Q EPS $1.13; EST. $1.20; YEAR VIEW CUT
    *UPS SEES YEAR ADJ. EPS $4.65-$4.85, SAW $4.80-$5.06, EST. $4.98

Shocker, its not all roses out there.

","['up', '-5', '%', 'premarket', '``', 'slow', 'us', 'industri', 'economi', ""''"", '*', 'up', 'expect', 'to', 'report', '2q', 'ep', '$', '1.13', ';', 'est', '.', '$', '1.20', ';', 'year', 'view', 'cut', '*', 'up', 'see', 'year', 'adj', '.', 'ep', '$', '4.65-', '$', '4.85', ',', 'saw', '$', '4.80-', '$', '5.06', ',', 'est', '.', '$', '4.98', 'shocker', ',', 'rose', '.']",[3 4 0 ... 0 0 0],10
479,5,Can BBRY get this squeeze on?,8,3,6,,"['can', 'bbri', 'get', 'squeez', '?', 'nan']",[0 0 0 ... 0 0 0],5
140,10,Mark's Weekly Log; Charts and Analysis,13,3,5,,"['mark', ""'s"", 'weekli', 'log', ';', 'chart', 'analysi', 'nan']",[0 0 0 ... 0 0 0],10
173,9,Peter Brandt predicting crude to drop to $65,9,0,1,,"['peter', 'brandt', 'predict', 'crude', 'drop', '$', '65', 'nan']",[0 0 0 ... 0 0 0],10
6,28,Apple Breaks Below $400 for First Time Since Dec. 2011,36,8,15,,"['appl', 'break', 'below', '$', '400', 'first', 'time', 'sinc', 'dec.', '2011', 'nan']",[0 0 0 ... 0 0 0],30
638,4,/r/StockMarket what is the best book to buy on investing?,6,2,15,"i am very young and also very smart (not cocky, i just have a massive drive to do well) what would be the best book or me to read to get into investing?","['/r/stockmarket', 'best', 'book', 'buy', 'invest', '?', 'young', 'also', 'smart', '(', 'cocki', ',', 'massiv', 'drive', 'well', ')', 'would', 'best', 'book', 'read', 'get', 'invest', '?']",[1 0 0 ... 0 0 0],5
942,2,Europe putting pressure on the morning open,4,2,0,,"['europ', 'put', 'pressur', 'morn', 'open', 'nan']",[0 0 0 ... 0 0 0],0
73,13,r/stockmarket hits 700 traders!,15,2,13,"New highs have been made for the r/stockmarket.. as Greece fears overhanging the market :P

Its great to see more participation from active traders here. When I took over this dormant subreddit in Jan it was completely dead except for some spam for viagra.

Im not really sure how much demand there is for this kind of short term financial content, but I know its stuff I like to see and judging by the growth over the past 2 months there may be at least 5 others out there who feel the same. :D

Thank you to the early adopters for your contributions!

If any of you see a stock moving on news, a chart break out or some geopolitical event that should or is moving the market, feel free to share!

If you are new to the markets, as indicated in the side bar, you should really begin your journey in the /r/investing section which is full of educational goodies and all the possible help you will need to get started in the markets.

AAPL to $1000! ","['r/stockmarket', 'hit', '700', 'trader', '!', 'new', 'high', 'made', 'r/stockmarket', '..', 'greec', 'fear', 'overhang', 'market', ':', 'p', 'it', 'great', 'see', 'particip', 'activ', 'trader', '.', 'when', 'i', 'took', 'dormant', 'subreddit', 'jan', 'complet', 'dead', 'except', 'spam', 'viagra', '.', 'im', 'realli', 'sure', 'much', 'demand', 'kind', 'short', 'term', 'financi', 'content', ',', 'i', 'know', 'stuff', 'i', 'like', 'see', 'judg', 'growth', 'past', '2', 'month', 'may', 'least', '5', 'other', 'feel', '.', ':', 'd', 'thank', 'earli', 'adopt', 'contribut', '!', 'if', 'see', 'stock', 'move', 'news', ',', 'chart', 'break', 'geopolit', 'event', 'move', 'market', ',', 'feel', 'free', 'share', '!', 'if', 'new', 'market', ',', 'indic', 'side', 'bar', ',', 'realli', 'begin', 'journey', '/r/invest', 'section', 'full', 'educ', 'goodi', 'possibl', 'help', 'need', 'get', 'start', 'market', '.', 'aapl', '$', '1000', '!']",[5 4 0 ... 0 0 0],15
679,6,"Wall Street Breakfast: Must-Know News November 7, 2012",6,0,0,,"['wall', 'street', 'breakfast', ':', 'must-know', 'new', 'novemb', '7', ',', '2012', 'nan']",[1 0 0 ... 0 0 0],5
405,5,Mark's Weekly Log; Charts and Analysis.,6,1,0,,"['mark', ""'s"", 'weekli', 'log', ';', 'chart', 'analysi', '.', 'nan']",[0 1 0 ... 0 0 0],5
238,7,GM (+7%) rises on govt exit from stock,9,2,2,,"['gm', '(', '+7', '%', ')', 'rise', 'govt', 'exit', 'stock', 'nan']",[0 0 0 ... 0 0 0],5
145,11,Another stock that has been going up in a straight channel,11,0,0,,"['anoth', 'stock', 'go', 'straight', 'channel', 'nan']",[0 0 0 ... 0 0 0],10
788,4,Publicly traded medical marijuana company begins developing diagnostic hardware,5,1,0,,"['publicli', 'trade', 'medic', 'marijuana', 'compani', 'begin', 'develop', 'diagnost', 'hardwar', 'nan']",[0 0 0 ... 0 0 0],5
234,7,Uh-Oh: NYT’s Front Page Cover Indicator | The Big Picture,12,5,5,,"['uh-oh', ':', 'nyt', '’', 'front', 'page', 'cover', 'indic', '|', 'the', 'big', 'pictur', 'nan']",[0 0 0 ... 0 0 0],5
220,7,"Forget defense, fear makes growth stocks cheap",14,7,0,,"['forget', 'defens', ',', 'fear', 'make', 'growth', 'stock', 'cheap', 'nan']",[1 0 0 ... 0 0 0],5
984,3,Riots spread across Athens,4,1,4,,"['riot', 'spread', 'across', 'athen', 'nan']",[0 0 0 ... 0 0 0],5
970,3,"P - Pandora earnings out, disappoint ",3,0,7,"-13% to 12.40 on earnings.

That hissing sound is the air being let out of these inflated names.

http://finviz.com/quote.ashx?t=p","['p', '-', 'pandora', 'earn', ',', 'disappoint', '-13', '%', '12.40', 'earn', '.', 'that', 'hiss', 'sound', 'air', 'let', 'inflat', 'name', '.', 'http', ':', '//finviz.com/quote.ashx', '?', 't=p']",[1 2 0 ... 0 0 0],5
132,10,Worst Fed day since 2011,10,0,11,"This kind of sell off on a Fed day has not been seen since 2011. 

Ben did not even say anything that took the market by surprise, everything was pretty much expected, and yet the sellers stepped up.

This could be a test by the Fed to see how the market reacts to more of the same. The risk to shorts is that the Fed can simply come back at any time and say ""More POMO for you!"".

Are you bullish and looking to buy this dip?

Are you bearish and hoping for a 10% correction from here?","['worst', 'fed', 'day', 'sinc', '2011', 'thi', 'kind', 'sell', 'fed', 'day', 'seen', 'sinc', '2011', '.', 'ben', 'even', 'say', 'anyth', 'took', 'market', 'surpris', ',', 'everyth', 'pretti', 'much', 'expect', ',', 'yet', 'seller', 'step', '.', 'thi', 'could', 'test', 'fed', 'see', 'market', 'react', '.', 'the', 'risk', 'short', 'fed', 'simpli', 'come', 'back', 'time', 'say', '``', 'more', 'pomo', '!', ""''"", '.', 'are', 'bullish', 'look', 'buy', 'dip', '?', 'are', 'bearish', 'hope', '10', '%', 'correct', '?']",[2 4 0 ... 0 0 0],10
985,3,"Groupon stock slides as latest results, outlook trigger worries about growth",3,0,0,,"['groupon', 'stock', 'slide', 'latest', 'result', ',', 'outlook', 'trigger', 'worri', 'growth', 'nan']",[1 0 0 ... 0 0 0],5
902,4,$SPRD: Head &amp; Shoulders Setup?  What do you guys think?,5,1,3,,"['$', 'sprd', ':', 'head', '&', 'amp', ';', 'shoulder', 'setup', '?', 'what', 'guy', 'think', '?', 'nan']",[0 0 0 ... 0 0 0],5
185,10,"DELL +10%, talks of going private. HPQ spikes 5%",11,1,9,"Just on the wires, DELL stock spiked on a report of a possible buyout. Two private equity firms are interested.

No other news yet, breaking story.

HPQ quick to react, they spiked +5% on the news.","['dell', '+10', '%', ',', 'talk', 'go', 'privat', '.', 'hpq', 'spike', '5', '%', 'just', 'wire', ',', 'dell', 'stock', 'spike', 'report', 'possibl', 'buyout', '.', 'two', 'privat', 'equiti', 'firm', 'interest', '.', 'no', 'news', 'yet', ',', 'break', 'stori', '.', 'hpq', 'quick', 'react', ',', 'spike', '+5', '%', 'news', '.']",[4 5 0 ... 0 0 0],10
41,16,Intrade giving Obama a solid lead this afternoon,26,10,16,,"['intrad', 'give', 'obama', 'solid', 'lead', 'afternoon', 'nan']",[0 0 0 ... 0 0 0],15
760,3,May 1st earning plays,5,2,7,"Earnings coming out from a few names you may recognize:

Pfizer, Archer Daniels, Avon, CBOE, Thomson Reuters, Chesapeake Energy, CBS, Motorola Mobility","['may', '1st', 'earn', 'play', 'earn', 'come', 'name', 'may', 'recogn', ':', 'pfizer', ',', 'archer', 'daniel', ',', 'avon', ',', 'cboe', ',', 'thomson', 'reuter', ',', 'chesapeak', 'energi', ',', 'cb', ',', 'motorola', 'mobil']",[7 0 0 ... 0 0 0],5
108,11,"AAPL inverted head n shoulder, but downtrend is intact",13,2,6,,"['aapl', 'invert', 'head', 'n', 'shoulder', ',', 'downtrend', 'intact', 'nan']",[1 0 0 ... 0 0 0],10
585,6,Shorted AAPL yesterday (chart inside),8,2,5,"Nice little short yesterday, couldn't hold above the $581 level. Will look to short again if we can't hold at $561. Thoughts?

http://imgur.com/NrIWg","['short', 'aapl', 'yesterday', '(', 'chart', 'insid', ')', 'nice', 'littl', 'short', 'yesterday', ',', 'could', ""n't"", 'hold', '$', '581', 'level', '.', 'will', 'look', 'short', 'ca', ""n't"", 'hold', '$', '561', '.', 'thought', '?', 'http', ':', '//imgur.com/nriwg']",[1 2 0 ... 0 0 0],5
56,13,IBM Shares Post Biggest Drop in 8 Years,15,2,2,,"['ibm', 'share', 'post', 'biggest', 'drop', '8', 'year', 'nan']",[0 0 0 ... 0 0 0],15
969,3,"MCD down -3%, international growth slowed",3,0,0,"WSJ - McDonald’s global same-store sales jumped a less-than-expected 7.5% in February as the fast-food giant’s international growth slowed. Shares fell 3.8% to $96.46 premarket.

http://finviz.com/chart.ashx?t=MCD&amp;ty=c&amp;ta=1&amp;p=d&amp;s=l

Check out the resistance level on the chart, the stock simply could not crack the $100 level. ","['mcd', '-3', '%', ',', 'intern', 'growth', 'slow', 'wsj', '-', 'mcdonald', '’', 'global', 'same-stor', 'sale', 'jump', 'less-than-expect', '7.5', '%', 'februari', 'fast-food', 'giant', '’', 'intern', 'growth', 'slow', '.', 'share', 'fell', '3.8', '%', '$', '96.46', 'premarket', '.', 'http', ':', '//finviz.com/chart.ashx', '?', 't=mcd', '&', 'amp', ';', 'ty=c', '&', 'amp', ';', 'ta=1', '&', 'amp', ';', 'p=d', '&', 'amp', ';', 's=l', 'check', 'resist', 'level', 'chart', ',', 'stock', 'simpli', 'could', 'crack', '$', '100', 'level', '.']",[2 3 0 ... 0 0 0],5
433,6,FB bounces off the $20 level +9%,8,2,5,,"['fb', 'bounc', '$', '20', 'level', '+9', '%', 'nan']",[0 0 0 ... 0 0 0],5
956,3,WU - Thoughts?,3,0,4,"Still currently paper trading and learning but came across WU down 1.51% on Friday's Close. 

Nice looking bearish engulfing candle, MACD and RSI are looking to the downside. Looking at either shorting once it breaks $17.50 or buying $19 May Put for a target of $17.00.

What do you guys think?

http://www.finviz.com/quote.ashx?t=WU","['wu', '-', 'thought', '?', 'still', 'current', 'paper', 'trade', 'learn', 'came', 'across', 'wu', '1.51', '%', 'friday', ""'s"", 'close', '.', 'nice', 'look', 'bearish', 'engulf', 'candl', ',', 'macd', 'rsi', 'look', 'downsid', '.', 'look', 'either', 'short', 'break', '$', '17.50', 'buy', '$', '19', 'may', 'put', 'target', '$', '17.00', '.', 'what', 'guy', 'think', '?', 'http', ':', '//www.finviz.com/quote.ashx', '?', 't=wu']",[1 3 0 ... 0 0 0],5
855,3,I am going to receive $2000 to invest in the Australian stock market. How would I approach choosing which shares to invest in?,5,2,7,"Ideally I would have half allocated to blue chip stocks and half to speculative stocks, preferably with a share price below $0.10 AUD.","['i', 'go', 'receiv', '$', '2000', 'invest', 'australian', 'stock', 'market', '.', 'how', 'would', 'i', 'approach', 'choos', 'share', 'invest', '?', 'ideal', 'i', 'would', 'half', 'alloc', 'blue', 'chip', 'stock', 'half', 'specul', 'stock', ',', 'prefer', 'share', 'price', '$', '0.10', 'aud', '.']",[1 2 0 ... 0 0 0],5
24,20,Fake Tweets About Syrian President Assad's Death Cause All Too Real Spike In Crude ,24,4,4,,"['fake', 'tweet', 'about', 'syrian', 'presid', 'assad', ""'s"", 'death', 'caus', 'all', 'too', 'real', 'spike', 'in', 'crude', 'nan']",[0 0 0 ... 0 0 0],20
635,3,"INVN, fitness motion tracking device company, is up 10% today",5,2,8,,"['invn', ',', 'fit', 'motion', 'track', 'devic', 'compani', ',', '10', '%', 'today', 'nan']",[2 0 0 ... 0 0 0],5
528,5,"ZNGA -10% afterhours, FB can now make its own games",6,1,2,"FB and ZNGA have changed their agreement, Facebook can now make their own games.

ZNGA plop.
","['znga', '-10', '%', 'afterhour', ',', 'fb', 'make', 'game', 'fb', 'znga', 'chang', 'agreement', ',', 'facebook', 'make', 'game', '.', 'znga', 'plop', '.']",[2 2 0 ... 0 0 0],5
615,5,S&amp;P 500 levels for Mon/Tues,5,0,2,,"['s', '&', 'amp', ';', 'p', '500', 'level', 'mon/tu', 'nan']",[0 0 0 ... 0 0 0],5
938,4,Asia Up but Investors Still Edgy Over Greece - Asia Business News  - CNBC,7,3,0,,"['asia', 'up', 'investor', 'still', 'edgi', 'over', 'greec', '-', 'asia', 'busi', 'new', '-', 'cnbc', 'nan']",[0 0 0 ... 0 0 0],5
921,3,T3: Markets start the week on the defensive,3,0,0,,"['t3', ':', 'market', 'start', 'week', 'defens', 'nan']",[0 0 0 ... 0 0 0],5
338,7,Technical chart: AAPL $530-$540 target?,9,2,6,"TL/DR - I think the $530-$540 range starts to bring buyers back.

Long version:

The big push in AAPL began in Jan when the stock gapped up $25 to the $450 range and took off from there. We call that a gap n go.

Since that was the launching point, I wanted to see the Fib levels from that point to the highs.

The 50% or halfway market between these levels is $540. 

Next I did some Elliott wave voodoo, assuming the bull stance on this would mean that this correction off the highs here is an ABC correction, if so then A=C (which is all neat and nice when that happens), that would put it around $532.
 

We also have a support  declining support level coming in around the same range.

This is what the technical analysts at the big firms will be showing their bosses. Whether they decide to act on this kind of stuff, we do not know, but in the $530-$540 range AAPL is $100 cheaper than the highs, which again, is a nice round number that might attract buyers.

[AAPL Chart May 16th](http://i.imgur.com/GCEUw.gif)","['technic', 'chart', ':', 'aapl', '$', '530-', '$', '540', 'target', '?', 'tl/dr', '-', 'i', 'think', '$', '530-', '$', '540', 'rang', 'start', 'bring', 'buyer', 'back', '.', 'long', 'version', ':', 'the', 'big', 'push', 'aapl', 'began', 'jan', 'stock', 'gap', '$', '25', '$', '450', 'rang', 'took', '.', 'we', 'call', 'gap', 'n', 'go', '.', 'sinc', 'launch', 'point', ',', 'i', 'want', 'see', 'fib', 'level', 'point', 'high', '.', 'the', '50', '%', 'halfway', 'market', 'level', '$', '540', '.', 'next', 'i', 'elliott', 'wave', 'voodoo', ',', 'assum', 'bull', 'stanc', 'would', 'mean', 'correct', 'high', 'abc', 'correct', ',', 'a=c', '(', 'neat', 'nice', 'happen', ')', ',', 'would', 'put', 'around', '$', '532', '.', 'we', 'also', 'support', 'declin', 'support', 'level', 'come', 'around', 'rang', '.', 'thi', 'technic', 'analyst', 'big', 'firm', 'show', 'boss', '.', 'whether', 'decid', 'act', 'kind', 'stuff', ',', 'know', ',', '$', '530-', '$', '540', 'rang', 'aapl', '$', '100', 'cheaper', 'high', ',', ',', 'nice', 'round', 'number', 'might', 'attract', 'buyer', '.', '[', 'aapl', 'chart', 'may', '16th', ']', '(', 'http', ':', '//i.imgur.com/gceuw.gif', ')']",[8 9 0 ... 0 0 0],5
51,14,$267 Billion more added to Operation Twist through 2012,17,3,2,,"['$', '267', 'billion', 'ad', 'oper', 'twist', '2012', 'nan']",[0 0 0 ... 0 0 0],15
861,3,"Wall Street Breakfast: Must-Know News November 15, 2012",4,1,0,,"['wall', 'street', 'breakfast', ':', 'must-know', 'new', 'novemb', '15', ',', '2012', 'nan']",[1 0 0 ... 0 0 0],5
513,7,"Gold Reclaims $1,600, as Cyprus Worries Raise Demand ",8,1,4,,"['gold', 'reclaim', '$', '1,600', ',', 'cypru', 'worri', 'rais', 'demand', 'nan']",[1 0 0 ... 0 0 0],5
915,3,Chart! S&amp;P Daily Symmetrical Triangle,4,1,4,"Original from my log.
http://cdn.hotstockmarket.com/d/d3/d3e03f6a_spxsymmetricaltriangle.png

New version a bit more symmetrical.
http://cdn.hotstockmarket.com/9/95/9536743b_dst.png","['chart', '!', 's', '&', 'amp', ';', 'p', 'daili', 'symmetr', 'triangl', 'origin', 'log', '.', 'http', ':', '//cdn.hotstockmarket.com/d/d3/d3e03f6a_spxsymmetricaltriangle.png', 'new', 'version', 'bit', 'symmetr', '.', 'http', ':', '//cdn.hotstockmarket.com/9/95/9536743b_dst.png']",[0 2 0 ... 0 0 0],5
629,5,Reuters: France downgraded from AAA,5,0,0,"Just on CNBC, no link yet.

S&amp;P credit agency has downgraded France

Markets -1%, not looking like any kind of over-reaction here, we sold off ahead of the news because of the banks. Might actually bounce here.","['reuter', ':', 'franc', 'downgrad', 'aaa', 'just', 'cnbc', ',', 'link', 'yet', '.', 's', '&', 'amp', ';', 'p', 'credit', 'agenc', 'downgrad', 'franc', 'market', '-1', '%', ',', 'look', 'like', 'kind', 'over-react', ',', 'sold', 'ahead', 'news', 'bank', '.', 'might', 'actual', 'bounc', '.']",[3 3 0 ... 0 0 0],5
264,6,"NFP Huge Miss At 69,000 On Expectations Of 150,000; Unemployment Rate 8.2%",8,2,6,,"['nfp', 'huge', 'miss', 'at', '69,000', 'on', 'expect', 'of', '150,000', ';', 'unemploy', 'rate', '8.2', '%', 'nan']",[0 0 0 ... 0 0 0],5
534,6,S&amp;P ultra long channel.,6,0,6,"Has anyone considered the idea that S&amp;P may be in an ultra long channel?

See chart: http://i.imgur.com/60yK4.jpg

We are quite close to the top of the channel around 1500.  If the channel holds then S&amp;P could be heading down to 700 in a couple years and there would be limited upside from where we are now.  I wouldn't be surprised if we've already seen the top in Sept.

The first run up was the dotcom bubble.  The second run up was on the back of the real estate boom.  What's the most recent run up based on?  Cheap credit?  Will that burst?

","['s', '&', 'amp', ';', 'p', 'ultra', 'long', 'channel', '.', 'ha', 'anyon', 'consid', 'idea', 's', '&', 'amp', ';', 'p', 'may', 'ultra', 'long', 'channel', '?', 'see', 'chart', ':', 'http', ':', '//i.imgur.com/60yk4.jpg', 'we', 'quit', 'close', 'top', 'channel', 'around', '1500', '.', 'if', 'channel', 'hold', 's', '&', 'amp', ';', 'p', 'could', 'head', '700', 'coupl', 'year', 'would', 'limit', 'upsid', '.', 'i', 'would', ""n't"", 'surpris', ""'ve"", 'alreadi', 'seen', 'top', 'sept', '.', 'the', 'first', 'run', 'dotcom', 'bubbl', '.', 'the', 'second', 'run', 'back', 'real', 'estat', 'boom', '.', 'what', ""'s"", 'recent', 'run', 'base', '?', 'cheap', 'credit', '?', 'will', 'burst', '?']",[0 6 0 ... 0 0 0],5
706,5,"QE3 hopes appear to be the driving catalyst for the moment, but with the DIJA @ 13K, how can I expect to see QE3 in August?  ",5,0,7,,"['qe3', 'hope', 'appear', 'drive', 'catalyst', 'moment', ',', 'dija', '@', '13k', ',', 'i', 'expect', 'see', 'qe3', 'august', '?', 'nan']",[2 0 0 ... 0 0 0],5
678,4,Mark's Weekly Log; Charts and Analysis.,4,0,4,,"['mark', ""'s"", 'weekli', 'log', ';', 'chart', 'analysi', '.', 'nan']",[0 1 0 ... 0 0 0],5
493,5,Pricing in the rise of real interest rates,6,1,2,,"['price', 'rise', 'real', 'interest', 'rate', 'nan']",[0 0 0 ... 0 0 0],5
626,5,France shrugs off downgrades,5,0,0,"Futures trading across the pond is actually pretty good today. France AAA downgrade seems to be digested, this market wants higher

http://www.nytimes.com/2012/01/17/business/global/daily-stock-market-activity.html","['franc', 'shrug', 'downgrad', 'futur', 'trade', 'across', 'pond', 'actual', 'pretti', 'good', 'today', '.', 'franc', 'aaa', 'downgrad', 'seem', 'digest', ',', 'market', 'want', 'higher', 'http', ':', '//www.nytimes.com/2012/01/17/business/global/daily-stock-market-activity.html']",[1 1 0 ... 0 0 0],5
836,2,David Rosenberg: 10 signs that show the stock market is overbought,6,4,0,,"['david', 'rosenberg', ':', '10', 'sign', 'show', 'stock', 'market', 'overbought', 'nan']",[0 0 0 ... 0 0 0],0
18,24,Live Day Trade for 4/11/13,28,4,34,"1. Back at it for the second day in a row with live day trades for everyone to follow.

Ill try to keep it updated to the minute as I did yesterday.  Im trading stocks between $.25 and $15, and standard is 5000 shares per trade.  

Target daily profit is $5000, try to be cash by the end of the day.

Leftover from yesterday:
* 25,000 shares of FMCC at .82
* VHC Apr 20 $22 calls at .85
* 2500 shares of JMBA at 1.83

1. 9:30 in ACAD 11.50
1. 9:34 in GRPN 6.20
1. 9:34 in XRX 9.0
1. 9:35 in JCP 114.27
1. 9:37 out GRPN 6.23 +.03
1. 9:38 in GEVO 2.30 
1. 9:41 in ROYL 3.23
1. 
9:42 in GALE 2.36
1. 9:44 in BYD 9.18
1. 9:46 in OWW 7.15
1. 
9:46 out JCP 14.50 +.23
1. 9:47 in PBHT 5.92
1. 9""48 out PBHT $6  +.08
1. 9:51 out XRX 9.10 +.10
1. 9:54 out JMBA from yesterday 2.82  -.01
1. 9:55 out BYD 9.25 +.07
1. 10:00 out OWW 7.35 +.20
1. 10""02 out ACAD 11.70 +.20  PATIENCE!!
1. 10:04 in RAD 2.07===  2.04  sorry
1. 10:08 in MM 6.48
1. 10:08 in ONNN 8.51
1. 10:10 in GLUU 2.92  10k shares
1. 10:12 in SPWR 11.20
1. 10:16 in EVC 3.58
1. 
10:18 in ARNA 8:17
1. 10:19 out EVC 3.63 +.05
1. 10:27 out GLUU 3.05 +.13  (i think it h as more, just locking in profits and focusing elsewhere)
1. 10:30 out MM 6.53 +.05
1. 10:35 in BIOL 4.87
1. 10:36 in ANAC 7.12
1. 10:38 in HALO 5.77
1. 10:38 out RAD 2.10 +.06
1. 10:40 out FMCC at .74   stupid trade -.08
1. 10:43 in GSIG 9.10
1. 10:45 in VVUS 11.6
1. 10:46 out GSIG 9  -.10
1. 11:01 in MCP 5.72
1. 110:03 out HALO 5.81 +.04
1. 11:05 out BIOL $5  +.23
1. 11:05 out ONN 8.56 +.05
1. 11:08 out GALE 2.41 +.05
1. 11:19 out MCP 5.75 +.03
1. 11:19 in ASTX 6.36
1. 11:25 in ACAD may 18 $12 calls at 1.10
1. 11:31 out ASTX 6.40 +.04
1. 11:36 in FNSR 11.40
1. 11:43 in CERS 4.69
1. 11:47 in GRPN 6.45
1. 11:48 out CERS 4.74 +.05
1. 11:48 out GRPN 6.48 +.03
1. 12:03 in JBLU 7.11
1. 12:14 in BYD 9.08 off curl
1. 12:17 out ANAC 7.18 +.06
1. 12:33 in CLDX 12.12
1. 12:40 out CLDX 12.20 +.08
1. 12:44 out ACAD calls may $12  1.50  +.40   37%!
1. 12:53 out JBLU 7.12 +.01  too lsoowww
1. 12:54 in may 18 $13 BBRY pits .81
1. 12:55 in ACAD 12.57
1. 12:59 out ACAD 12.65 +.08
1. 1:01 in HMA 10.90
1. 1:04 in CPE 3.96 for move into 4s
1. 1:07 in RNIN 1.90
1. 1:09 out RNIN 1.95 +.05
1. 1:10 out SPWR 11.26 +.06
1. 1:44 in ACAD 12.89
1. 1:46 in NVDA 12.71
1. 1:48 out NVDA 12.60 -.11  
1. 1:54 in GOL 5.85
1. 1:57 out GOL 5.88 +.03
1. 1:59 out HMA 10.81 -.09
1. 2:02 in HLF weekly $39 puts .75
1. 2:04 out ROYL 3.13 -.10  i hate that one
1. 2:06 out CPE 3.94 -.02
1. 2:24 out ACAD 13.10 +.21
1. 2:24 in BMC apr 20 $46 calls .50
1. 2:25 in ACAD 13.14
1. 2:28 out ACAD 13.33 +.19
1. 2:30 out VVUS 11.51 -.09
1. 2:33 in ACAD 13.30
1. 2:35 out ACAD 13.40 +.10
1. 2:43 in ACAD 13.45
1. 2:47 out ACAD 13.80 +.35
1. 2:50 in ACAD may 18 $14 puts at 1.90.   doesnt hold tomrrow
1. 2:57 out HLF $39 puts @ 1.10  +.35  47%
1. 2:59 in BBY june 22 $24 puts  2.25
1. 3:02 out ARNA 8.12 -.05
1. 3:03 out BYD 8.99 -.09
1. 3:12 out FNSR 14.36 -.04


DONE FOR THE DAY.  TOTAL PROFIT OF $10,500.  still holding GEVO for a long term hold, wainting on the levurne plant opening.  Also still have ACAD puts, and VHC $22 calls

gotta go take care of some shit out in town, but will be back later on to answer any questions","['live', 'day', 'trade', '4/11/13', '1', '.', 'back', 'second', 'day', 'row', 'live', 'day', 'trade', 'everyon', 'follow', '.', 'ill', 'tri', 'keep', 'updat', 'minut', 'i', 'yesterday', '.', 'im', 'trade', 'stock', '$', '.25', '$', '15', ',', 'standard', '5000', 'share', 'per', 'trade', '.', 'target', 'daili', 'profit', '$', '5000', ',', 'tri', 'cash', 'end', 'day', '.', 'leftov', 'yesterday', ':', '*', '25,000', 'share', 'fmcc', '.82', '*', 'vhc', 'apr', '20', '$', '22', 'call', '.85', '*', '2500', 'share', 'jmba', '1.83', '1', '.', '9:30', 'acad', '11.50', '1', '.', '9:34', 'grpn', '6.20', '1', '.', '9:34', 'xrx', '9.0', '1', '.', '9:35', 'jcp', '114.27', '1', '.', '9:37', 'grpn', '6.23', '+.03', '1', '.', '9:38', 'gevo', '2.30', '1', '.', '9:41', 'royl', '3.23', '1', '.', '9:42', 'gale', '2.36', '1', '.', '9:44', 'byd', '9.18', '1', '.', '9:46', 'oww', '7.15', '1', '.', '9:46', 'jcp', '14.50', '+.23', '1', '.', '9:47', 'pbht', '5.92', '1', '.', '9', ""''"", '48', 'pbht', '$', '6', '+.08', '1', '.', '9:51', 'xrx', '9.10', '+.10', '1', '.', '9:54', 'jmba', 'yesterday', '2.82', '-.01', '1', '.', '9:55', 'byd', '9.25', '+.07', '1', '.', '10:00', 'oww', '7.35', '+.20', '1', '.', '10', ""''"", '02', 'acad', '11.70', '+.20', 'patienc', '!', '!', '1', '.', '10:04', 'rad', '2.07===', '2.04', 'sorri', '1', '.', '10:08', 'mm', '6.48', '1', '.', '10:08', 'onnn', '8.51', '1', '.', '10:10', 'gluu', '2.92', '10k', 'share', '1', '.', '10:12', 'spwr', '11.20', '1', '.', '10:16', 'evc', '3.58', '1', '.', '10:18', 'arna', '8:17', '1', '.', '10:19', 'evc', '3.63', '+.05', '1', '.', '10:27', 'gluu', '3.05', '+.13', '(', 'think', 'h', ',', 'lock', 'profit', 'focus', 'elsewher', ')', '1', '.', '10:30', 'mm', '6.53', '+.05', '1', '.', '10:35', 'biol', '4.87', '1', '.', '10:36', 'anac', '7.12', '1', '.', '10:38', 'halo', '5.77', '1', '.', '10:38', 'rad', '2.10', '+.06', '1', '.', '10:40', 'fmcc', '.74', 'stupid', 'trade', '-.08', '1', '.', '10:43', 'gsig', '9.10', '1', '.', '10:45', 'vvu', '11.6', '1', '.', '10:46', 'gsig', '9', '-.10', '1', '.', '11:01', 'mcp', '5.72', '1', '.', '110:03', 'halo', '5.81', '+.04', '1', '.', '11:05', 'biol', '$', '5', '+.23', '1', '.', '11:05', 'onn', '8.56', '+.05', '1', '.', '11:08', 'gale', '2.41', '+.05', '1', '.', '11:19', 'mcp', '5.75', '+.03', '1', '.', '11:19', 'astx', '6.36', '1', '.', '11:25', 'acad', 'may', '18', '$', '12', 'call', '1.10', '1', '.', '11:31', 'astx', '6.40', '+.04', '1', '.', '11:36', 'fnsr', '11.40', '1', '.', '11:43', 'cer', '4.69', '1', '.', '11:47', 'grpn', '6.45', '1', '.', '11:48', 'cer', '4.74', '+.05', '1', '.', '11:48', 'grpn', '6.48', '+.03', '1', '.', '12:03', 'jblu', '7.11', '1', '.', '12:14', 'byd', '9.08', 'curl', '1', '.', '12:17', 'anac', '7.18', '+.06', '1', '.', '12:33', 'cldx', '12.12', '1', '.', '12:40', 'cldx', '12.20', '+.08', '1', '.', '12:44', 'acad', 'call', 'may', '$', '12', '1.50', '+.40', '37', '%', '!', '1', '.', '12:53', 'jblu', '7.12', '+.01', 'lsoowww', '1', '.', '12:54', 'may', '18', '$', '13', 'bbri', 'pit', '.81', '1', '.', '12:55', 'acad', '12.57', '1', '.', '12:59', 'acad', '12.65', '+.08', '1', '.', '1:01', 'hma', '10.90', '1', '.', '1:04', 'cpe', '3.96', 'move', '4s', '1', '.', '1:07', 'rnin', '1.90', '1', '.', '1:09', 'rnin', '1.95', '+.05', '1', '.', '1:10', 'spwr', '11.26', '+.06', '1', '.', '1:44', 'acad', '12.89', '1', '.', '1:46', 'nvda', '12.71', '1', '.', '1:48', 'nvda', '12.60', '-.11', '1', '.', '1:54', 'gol', '5.85', '1', '.', '1:57', 'gol', '5.88', '+.03', '1', '.', '1:59', 'hma', '10.81', '-.09', '1', '.', '2:02', 'hlf', 'weekli', '$', '39', 'put', '.75', '1', '.', '2:04', 'royl', '3.13', '-.10', 'hate', 'one', '1', '.', '2:06', 'cpe', '3.94', '-.02', '1', '.', '2:24', 'acad', '13.10', '+.21', '1', '.', '2:24', 'bmc', 'apr', '20', '$', '46', 'call', '.50', '1', '.', '2:25', 'acad', '13.14', '1', '.', '2:28', 'acad', '13.33', '+.19', '1', '.', '2:30', 'vvu', '11.51', '-.09', '1', '.', '2:33', 'acad', '13.30', '1', '.', '2:35', 'acad', '13.40', '+.10', '1', '.', '2:43', 'acad', '13.45', '1', '.', '2:47', 'acad', '13.80', '+.35', '1', '.', '2:50', 'acad', 'may', '18', '$', '14', 'put', '1.90.', 'doesnt', 'hold', 'tomrrow', '1', '.', '2:57', 'hlf', '$', '39', 'put', '@', '1.10', '+.35', '47', '%', '1', '.', '2:59', 'bbi', 'june', '22', '$', '24', 'put', '2.25', '1', '.', '3:02', 'arna', '8.12', '-.05', '1', '.', '3:03', 'byd', '8.99', '-.09', '1', '.', '3:12', 'fnsr', '14.36', '-.04', 'done', 'for', 'the', 'day', '.', 'total', 'profit', 'of', '$', '10,500', '.', 'still', 'hold', 'gevo', 'long', 'term', 'hold', ',', 'waint', 'levurn', 'plant', 'open', '.', 'also', 'still', 'acad', 'put', ',', 'vhc', '$', '22', 'call', 'got', 'ta', 'go', 'take', 'care', 'shit', 'town', ',', 'back', 'later', 'answer', 'question']",[ 6 97  0 ...  0  0  0],25
711,5,Marco's HSM Sentiment Polls,6,1,2,"Links for two new polls.
Love to see everyone participate in the fun with their opinions at HSM.

For the week of 7/23-7/27:
http://www.hotstockmarket.com/t/241133/marcos-weekly-sentiment-poll-7-23-7-27

For the month of August:
http://www.hotstockmarket.com/t/241136/marcos-monthly-hsm-sentiment-poll-for-august

VOTE! ","['marco', ""'s"", 'hsm', 'sentiment', 'poll', 'link', 'two', 'new', 'poll', '.', 'love', 'see', 'everyon', 'particip', 'fun', 'opinion', 'hsm', '.', 'for', 'week', '7/23-7/27', ':', 'http', ':', '//www.hotstockmarket.com/t/241133/marcos-weekly-sentiment-poll-7-23-7-27', 'for', 'month', 'august', ':', 'http', ':', '//www.hotstockmarket.com/t/241136/marcos-monthly-hsm-sentiment-poll-for-august', 'vote', '!']",[0 2 0 ... 0 0 0],5
500,6,Salesforce.com buying ExactTarget for $2.34B,7,1,1,,"['salesforce.com', 'buy', 'exacttarget', '$', '2.34b', 'nan']",[0 0 0 ... 0 0 0],5
596,5,Biggest % gainers pre-market May 10th,6,1,17,"Something a little different today, here are the biggest gainers pre-market! 

EXLP	Exterran Partners LP	23.61	17.58%

ZIP	Zipcar Inc	11.87	16.60%

INSP	InfoSpace Inc	12.49	13.75%

MNST	Monster Beverage Corporation	73.25	12.16%

NP	Neenah Paper Inc	30.04	10.64%

DBV	PowerShares DB G10 Curr Harvst	26.54	9.71%

QUAD	Quad / Graphics Inc	13.50	9.67%

ARAY	Accuray Inc	7.14	8.51%

TSLA	Tesla Motors Inc	32.50	8.12%

TWIN	Twin Disc Inc	20.68	7.37%
","['biggest', '%', 'gainer', 'pre-market', 'may', '10th', 'someth', 'littl', 'differ', 'today', ',', 'biggest', 'gainer', 'pre-market', '!', 'exlp', 'exterran', 'partner', 'lp', '23.61', '17.58', '%', 'zip', 'zipcar', 'inc', '11.87', '16.60', '%', 'insp', 'infospac', 'inc', '12.49', '13.75', '%', 'mnst', 'monster', 'beverag', 'corpor', '73.25', '12.16', '%', 'np', 'neenah', 'paper', 'inc', '30.04', '10.64', '%', 'dbv', 'powershar', 'db', 'g10', 'curr', 'harvst', '26.54', '9.71', '%', 'quad', 'quad', '/', 'graphic', 'inc', '13.50', '9.67', '%', 'aray', 'accuray', 'inc', '7.14', '8.51', '%', 'tsla', 'tesla', 'motor', 'inc', '32.50', '8.12', '%', 'twin', 'twin', 'disc', 'inc', '20.68', '7.37', '%']",[1 0 0 ... 0 0 0],5
424,6,Stock Market wrap for Aug 31st from AlphaTrends,7,1,0,,"['stock', 'market', 'wrap', 'aug', '31st', 'alphatrend', 'nan']",[0 0 0 ... 0 0 0],5
367,6,MrTopStep Closing Print 07-30-13,9,3,1,,"['mrtopstep', 'close', 'print', '07-30-13', 'nan']",[0 0 0 ... 0 0 0],5
83,13,More Stimulus is here.,14,1,1,,"['more', 'stimulu', '.', 'nan']",[0 1 0 ... 0 0 0],15
61,16,Groupon ousts co-founder Andrew Mason as CEO; shares jump 6%,18,2,7,,"['groupon', 'oust', 'co-found', 'andrew', 'mason', 'ceo', ';', 'share', 'jump', '6', '%', 'nan']",[0 0 0 ... 0 0 0],15
428,4,Same headlines every day this week,7,3,14,"This entire week has been like this:

If markets green, headlines = Markets rally on Fed hopes
If markets red, headlines = Markets sell off on Fed fears

Today is green, so guess what the headline is?


Stocks pop on Fed chairman's letter

USA TODAY - 4 hours ago
NEW YORK (AP) - The stock market keeps getting tossed around by the Fed. Stocks opened lower Friday but turned around after a letter surfaced from Federal Reserve Chairman Ben Bernanke suggesting there was room for the central bank to do more","['same', 'headlin', 'everi', 'day', 'week', 'thi', 'entir', 'week', 'like', ':', 'if', 'market', 'green', ',', 'headlin', '=', 'market', 'ralli', 'fed', 'hope', 'if', 'market', 'red', ',', 'headlin', '=', 'market', 'sell', 'fed', 'fear', 'today', 'green', ',', 'guess', 'headlin', '?', 'stock', 'pop', 'fed', 'chairman', ""'s"", 'letter', 'usa', 'today', '-', '4', 'hour', 'ago', 'new', 'york', '(', 'ap', ')', '-', 'the', 'stock', 'market', 'keep', 'get', 'toss', 'around', 'fed', '.', 'stock', 'open', 'lower', 'friday', 'turn', 'around', 'letter', 'surfac', 'feder', 'reserv', 'chairman', 'ben', 'bernank', 'suggest', 'room', 'central', 'bank']",[3 1 0 ... 0 0 0],5
272,9,AAPL gets a rare downgrade.. and onto new highs :),9,0,11,"The horror... the horror:

You haven’t seen a downgrade of Apple (AAPL) stock in a while, but this morning BTIG Research’s Walter Piecyk this cut his rating to Neutral from Buy, arguing that “changing dynamics” of the wireless industry may force changes in the company’s sales of the iPhone.

http://blogs.barrons.com/techtraderdaily/2012/04/09/apple-btig-cuts-to-hold-iphone-subsidies-could-dry-up/?mod=yahoobarrons","['aapl', 'get', 'rare', 'downgrad', '..', 'onto', 'new', 'high', ':', ')', 'the', 'horror', '...', 'horror', ':', 'you', '’', 'seen', 'downgrad', 'appl', '(', 'aapl', ')', 'stock', ',', 'morn', 'btig', 'research', '’', 'walter', 'piecyk', 'cut', 'rate', 'neutral', 'buy', ',', 'argu', '“', 'chang', 'dynam', '”', 'wireless', 'industri', 'may', 'forc', 'chang', 'compani', '’', 'sale', 'iphon', '.', 'http', ':', '//blogs.barrons.com/techtraderdaily/2012/04/09/apple-btig-cuts-to-hold-iphone-subsidies-could-dry-up/', '?', 'mod=yahoobarron']",[2 1 0 ... 0 0 0],10
285,7,"BBY +13%, offering space in store to offer Samsung boutiques",7,0,1,"Best Buy up 13% on news that Samsung launching boutiques.

Interesting news, but Im not sure that would make me go to Best Buy to buy anything.

https://www.tradingview.com/x/0rWi0n1s/","['bbi', '+13', '%', ',', 'offer', 'space', 'store', 'offer', 'samsung', 'boutiqu', 'best', 'buy', '13', '%', 'news', 'samsung', 'launch', 'boutiqu', '.', 'interest', 'news', ',', 'im', 'sure', 'would', 'make', 'go', 'best', 'buy', 'buy', 'anyth', '.', 'http', ':', '//www.tradingview.com/x/0rwi0n1s/']",[2 2 0 ... 0 0 0],5
360,6,"GOOG misses estimates, down -9% AH",7,1,10,"GOOGLE 4Q ADJ. EPS $9.50, EST. $10.50 

http://finviz.com/chart.ashx?t=GOOG&amp;ty=c&amp;ta=1&amp;p=d&amp;s=l","['goog', 'miss', 'estim', ',', '-9', '%', 'ah', 'googl', '4q', 'adj', '.', 'ep', '$', '9.50', ',', 'est', '.', '$', '10.50', 'http', ':', '//finviz.com/chart.ashx', '?', 't=goog', '&', 'amp', ';', 'ty=c', '&', 'amp', ';', 'ta=1', '&', 'amp', ';', 'p=d', '&', 'amp', ';', 's=l']",[2 2 0 ... 0 0 0],5
354,7,S&amp;P downward channel target for a bounce,7,0,5,,"['s', '&', 'amp', ';', 'p', 'downward', 'channel', 'target', 'bounc', 'nan']",[0 0 0 ... 0 0 0],5
447,6,Thought I'd share the McClellan Oscillator - chart inside,9,3,6,"A lot of traders I follow use this to determine oversold/overbought areas of the market. Its a pretty strong indicator and I generally keep my eyes on it during rallys/sell-offs. Generally levels above/below 200 are considered overbought/oversold. Yesterday we hit 321 indicating that this market market was overbought. 

http://imgur.com/ztIXC","['thought', 'i', ""'d"", 'share', 'mcclellan', 'oscil', '-', 'chart', 'insid', 'a', 'lot', 'trader', 'i', 'follow', 'use', 'determin', 'oversold/overbought', 'area', 'market', '.', 'it', 'pretti', 'strong', 'indic', 'i', 'gener', 'keep', 'eye', 'rallys/sell-off', '.', 'gener', 'level', 'above/below', '200', 'consid', 'overbought/oversold', '.', 'yesterday', 'hit', '321', 'indic', 'market', 'market', 'overbought', '.', 'http', ':', '//imgur.com/ztixc']",[0 4 0 ... 0 0 0],5
278,6,MrTopStep Closing Print Video 07-31-2013,7,1,0,,"['mrtopstep', 'close', 'print', 'video', '07-31-2013', 'nan']",[0 0 0 ... 0 0 0],5
12,26,"To all traders and investors of r/stockmarket, welcome! Tips and tricks for us to get the most out of this subreddit!",29,3,20,"Hello trader

Welcome to Reddits front page to the stock market!

This was an abandoned subreddit until earlier this year when I took it over. There was no activity and hardly any subscribers, but I felt the need for a more active stock market reddit (I mod r/investing), so I started posting here.

We are starting to see a lot more activity and contributions from traders every day!

What can you do to help?

We all follow our own little universe of stocks and financial sites. If you see something informative or potentially market moving, post it here! It is impossible for any one person to cover everything, so the more eyeballs we have out there, the better for everybody!

Browse over CNBC, Bloomberg, thestreet.com, optionmonster.com, find something interesting and share!

Do you have a question about a stock or a trade idea? Post it! 

Want to get a chart up or even draw some pretty lines on it? Some very easy sites you can do that with, try tradingview.com or freestockcharts.com. You can easily take a snap shot and insert it into your post.

While my personal trading style is rather technical heavy, yours does not have to be, in fact I encourage different methods as much as possible, it allows us to compare notes and help each other out.

Do not be intimidated if you feel your level of knowledge if below others, we all had to start somewhere! In fact, I will give karma to the dumbest question of the day!

Looking forward to reading your posts!

StockJock-e","['to', 'trader', 'investor', 'r/stockmarket', ',', 'welcom', '!', 'tip', 'trick', 'us', 'get', 'subreddit', '!', 'hello', 'trader', 'welcom', 'reddit', 'front', 'page', 'stock', 'market', '!', 'thi', 'abandon', 'subreddit', 'earlier', 'year', 'i', 'took', '.', 'there', 'activ', 'hardli', 'subscrib', ',', 'i', 'felt', 'need', 'activ', 'stock', 'market', 'reddit', '(', 'i', 'mod', 'r/invest', ')', ',', 'i', 'start', 'post', '.', 'we', 'start', 'see', 'lot', 'activ', 'contribut', 'trader', 'everi', 'day', '!', 'what', 'help', '?', 'we', 'follow', 'littl', 'univers', 'stock', 'financi', 'site', '.', 'if', 'see', 'someth', 'inform', 'potenti', 'market', 'move', ',', 'post', '!', 'it', 'imposs', 'one', 'person', 'cover', 'everyth', ',', 'eyebal', ',', 'better', 'everybodi', '!', 'brows', 'cnbc', ',', 'bloomberg', ',', 'thestreet.com', ',', 'optionmonster.com', ',', 'find', 'someth', 'interest', 'share', '!', 'do', 'question', 'stock', 'trade', 'idea', '?', 'post', '!', 'want', 'get', 'chart', 'even', 'draw', 'pretti', 'line', '?', 'some', 'easi', 'site', ',', 'tri', 'tradingview.com', 'freestockcharts.com', '.', 'you', 'easili', 'take', 'snap', 'shot', 'insert', 'post', '.', 'while', 'person', 'trade', 'style', 'rather', 'technic', 'heavi', ',', ',', 'fact', 'i', 'encourag', 'differ', 'method', 'much', 'possibl', ',', 'allow', 'us', 'compar', 'note', 'help', '.', 'do', 'intimid', 'feel', 'level', 'knowledg', 'other', ',', 'start', 'somewher', '!', 'in', 'fact', ',', 'i', 'give', 'karma', 'dumbest', 'question', 'day', '!', 'look', 'forward', 'read', 'post', '!', 'stockjock-']",[16  6  0 ...  0  0  0],25
182,9,Mark's Weekly Trading Log (3/11-3/15) Charts and Analysis,10,1,9,,"['mark', ""'s"", 'weekli', 'trade', 'log', '(', '3/11-3/15', ')', 'chart', 'analysi', 'nan']",[0 0 0 ... 0 0 0],10
368,7,Structure of Price Action: Trading the Opening Range,9,2,14,,"['structur', 'price', 'action', ':', 'trade', 'open', 'rang', 'nan']",[0 0 0 ... 0 0 0],5
483,5,"A list of useful websites, applications or programs",5,0,6,"Hey guys,

I am going to try my hand st the Stock Market and I was wondering if someone could give me a list of helpful websites, programs, applications and any other useful tips or advice, or even a general run-down of the works.

I certainly appreciate anything ya'll can give me. 

Thanks for your time.","['a', 'list', 'use', 'websit', ',', 'applic', 'program', 'hey', 'guy', ',', 'i', 'go', 'tri', 'hand', 'st', 'stock', 'market', 'i', 'wonder', 'someon', 'could', 'give', 'list', 'help', 'websit', ',', 'program', ',', 'applic', 'use', 'tip', 'advic', ',', 'even', 'gener', 'run-down', 'work', '.', 'i', 'certainli', 'appreci', 'anyth', 'ya', ""'ll"", 'give', '.', 'thank', 'time', '.']",[5 3 0 ... 0 0 0],5
958,3,[IWM] broken neck on HS for R2K leads to nice gainz for shorts.,3,0,4,,"['[', 'iwm', ']', 'broken', 'neck', 'hs', 'r2k', 'lead', 'nice', 'gainz', 'short', '.', 'nan']",[0 1 0 ... 0 0 0],5
223,8,"Amazing action in CSCO today, +12%",9,1,3,"Its been a while since Ive seen this kind of excitement by the bulls for CSCO, which is considered one of the old guard.

http://finviz.com/quote.ashx?t=csco


&gt;SAN FRANCISCO (MarketWatch) — Cisco Systems Inc. led a rally across much of the tech sector on Thursday, after the network equipment giant beat earnings estimates and painted an upbeat picture of the corporate tech market. ","['amaz', 'action', 'csco', 'today', ',', '+12', '%', 'it', 'sinc', 'ive', 'seen', 'kind', 'excit', 'bull', 'csco', ',', 'consid', 'one', 'old', 'guard', '.', 'http', ':', '//finviz.com/quote.ashx', '?', 't=csco', '&', 'gt', ';', 'san', 'francisco', '(', 'marketwatch', ')', '—', 'cisco', 'system', 'inc.', 'led', 'ralli', 'across', 'much', 'tech', 'sector', 'thursday', ',', 'network', 'equip', 'giant', 'beat', 'earn', 'estim', 'paint', 'upbeat', 'pictur', 'corpor', 'tech', 'market', '.']",[3 2 0 ... 0 0 0],10
595,5,More on JP Morgan's London Whale,6,1,2,,"['more', 'jp', 'morgan', ""'s"", 'london', 'whale', 'nan']",[0 0 0 ... 0 0 0],5
695,3,Toll Brothers orders rise sharply amid housing recovery,5,2,1,,"['toll', 'brother', 'order', 'rise', 'sharpli', 'amid', 'hous', 'recoveri', 'nan']",[0 0 0 ... 0 0 0],5
494,6,What's your outlook on the Dollar?,8,2,5,"Dollar Futures /DX - Looks like it popped back into last month's rotation and is still showing some strength above 82.55. Looking ahead to next month, I have my top rotational level at 83.57 and lower at 80.47. The most active price for the previous 3 month's is 82.30 with the bottom rotation at 81.70. 

http://www.hotstockmarket.com/g/i/179549/a/142983/currency-futures/sort/display_order/

I'm currently long the Canadian Dollar .9475 so I would like to see this strength in the dollar dissipate some.","['what', ""'s"", 'outlook', 'dollar', '?', 'dollar', 'futur', '/dx', '-', 'look', 'like', 'pop', 'back', 'last', 'month', ""'s"", 'rotat', 'still', 'show', 'strength', '82.55', '.', 'look', 'ahead', 'next', 'month', ',', 'i', 'top', 'rotat', 'level', '83.57', 'lower', '80.47', '.', 'the', 'activ', 'price', 'previou', '3', 'month', ""'s"", '82.30', 'bottom', 'rotat', '81.70.', 'http', ':', '//www.hotstockmarket.com/g/i/179549/a/142983/currency-futures/sort/display_order/', 'i', ""'m"", 'current', 'long', 'canadian', 'dollar', '.9475', 'i', 'would', 'like', 'see', 'strength', 'dollar', 'dissip', '.']",[1 3 0 ... 0 0 0],5
576,5,"ARNA obesity drug approved, VVUS OREX rally",7,2,5,"ARNA still halted, but it will get that pop on the approval.

Competitors VVUS and OREX catching a wicked rally here.","['arna', 'obes', 'drug', 'approv', ',', 'vvu', 'orex', 'ralli', 'arna', 'still', 'halt', ',', 'get', 'pop', 'approv', '.', 'competitor', 'vvu', 'orex', 'catch', 'wick', 'ralli', '.']",[2 2 0 ... 0 0 0],5
653,4,What determines the gold prices?,5,1,4,"I have always noticed every time dollar price goes up, gold price goes down. When I say dollar price, I mean dollar against foreign currencies.  ","['what', 'determin', 'gold', 'price', '?', 'i', 'alway', 'notic', 'everi', 'time', 'dollar', 'price', 'goe', ',', 'gold', 'price', 'goe', '.', 'when', 'i', 'say', 'dollar', 'price', ',', 'i', 'mean', 'dollar', 'foreign', 'currenc', '.']",[2 2 0 ... 0 0 0],5
605,6,"KBH -4.8%, this is not a repeat of Friday",6,0,2,"Housing numbers come in bad. Again.

Have no fear! Bernanke has your back!

KBH longs feeling the pain though, this drop here takes back the bounce after the drop last week.

http://finviz.com/quote.ashx?t=kbh","['kbh', '-4.8', '%', ',', 'repeat', 'friday', 'hous', 'number', 'come', 'bad', '.', 'again', '.', 'have', 'fear', '!', 'bernank', 'back', '!', 'kbh', 'long', 'feel', 'pain', 'though', ',', 'drop', 'take', 'back', 'bounc', 'drop', 'last', 'week', '.', 'http', ':', '//finviz.com/quote.ashx', '?', 't=kbh']",[2 3 0 ... 0 0 0],5
176,8,Divergence in credit markets widening!,11,3,8,,"['diverg', 'credit', 'market', 'widen', '!', 'nan']",[0 0 0 ... 0 0 0],10
662,5,"The Rule of 20 - Stable earnings, stable inflation. Only higher P/Es will lift this market. That necessitates higher investor confidence",6,1,0,,"['the', 'rule', '20', '-', 'stabl', 'earn', ',', 'stabl', 'inflat', '.', 'onli', 'higher', 'p/e', 'lift', 'market', '.', 'that', 'necessit', 'higher', 'investor', 'confid', 'nan']",[1 2 0 ... 0 0 0],5
667,4,Any thoughts on mbia?,4,0,1,Haven't heard a lot about the on going court case with bac and I am told it will make or break the stock. Was hoping to get some insight on the future of the company with one ruling vs the other,"['ani', 'thought', 'mbia', '?', 'have', ""n't"", 'heard', 'lot', 'go', 'court', 'case', 'bac', 'i', 'told', 'make', 'break', 'stock', '.', 'wa', 'hope', 'get', 'insight', 'futur', 'compani', 'one', 'rule', 'vs']",[0 1 0 ... 0 0 0],5
582,4,I forgot todays top 10 movers!,8,4,5,"Here are todays top 10 percentage movers as of 15:30, looks like penny junk but also the National Bank of Greece NBG... go figure.

NEI(F)	Network Engines	1.43	82.96%

GALE	Galena Biopharma Inc	1.55	19.92%

IVN.R*	Ivanhoe Mines Ltd Rights W/I	1.23	18.27%

CTRN	Citi Trends Inc	15.60	13.54%

NBG	National Bank Of Greece ADS	1.93	13.51%

VRNG	Vringo Inc	4.56	13.43%

NWK	Network Equip Tech	1.32	11.86%

DGAZ	VS 3x Inverse Natural Gas ETN	46.41	10.47%

OCLR	Oclaro Inc	2.80	10.24%

BONT	Bon-Ton Stores	5.90	10.07%

","['i', 'forgot', 'today', 'top', '10', 'mover', '!', 'here', 'today', 'top', '10', 'percentag', 'mover', '15:30', ',', 'look', 'like', 'penni', 'junk', 'also', 'nation', 'bank', 'greec', 'nbg', '...', 'go', 'figur', '.', 'nei', '(', 'f', ')', 'network', 'engin', '1.43', '82.96', '%', 'gale', 'galena', 'biopharma', 'inc', '1.55', '19.92', '%', 'ivn.r', '*', 'ivanho', 'mine', 'ltd', 'right', 'w/i', '1.23', '18.27', '%', 'ctrn', 'citi', 'trend', 'inc', '15.60', '13.54', '%', 'nbg', 'nation', 'bank', 'of', 'greec', 'ad', '1.93', '13.51', '%', 'vrng', 'vringo', 'inc', '4.56', '13.43', '%', 'nwk', 'network', 'equip', 'tech', '1.32', '11.86', '%', 'dgaz', 'vs', '3x', 'invers', 'natur', 'ga', 'etn', '46.41', '10.47', '%', 'oclr', 'oclaro', 'inc', '2.80', '10.24', '%', 'bont', 'bon-ton', 'store', '5.90', '10.07', '%']",[1 1 0 ... 0 0 0],5
986,3,Caution on BVSN,3,0,0,"One of the big movers from this mornings list, watch out there, the volatility is deadly.

From $20 to $45 to $30's all within 5 sessions, somebody is going to get burned here.

http://finviz.com/quote.ashx?t=bvsn

If you are a daytrader, knock yourself out! :)
","['caution', 'bvsn', 'one', 'big', 'mover', 'morn', 'list', ',', 'watch', ',', 'volatil', 'deadli', '.', 'from', '$', '20', '$', '45', '$', '30', ""'s"", 'within', '5', 'session', ',', 'somebodi', 'go', 'get', 'burn', '.', 'http', ':', '//finviz.com/quote.ashx', '?', 't=bvsn', 'if', 'daytrad', ',', 'knock', '!', ':', ')']",[4 2 0 ... 0 0 0],5
393,6,Mark's Weekly Trading Log (3/18-3/22) Charts and Analysis,7,1,0,,"['mark', ""'s"", 'weekli', 'trade', 'log', '(', '3/18-3/22', ')', 'chart', 'analysi', 'nan']",[0 0 0 ... 0 0 0],5
163,9,"Carl Icahn's Apple Stake, The Tweet And The Efficient Markets Hypothesis",10,1,12,,"['carl', 'icahn', ""'s"", 'appl', 'stake', ',', 'the', 'tweet', 'and', 'the', 'effici', 'market', 'hypothesi', 'nan']",[1 0 0 ... 0 0 0],10
248,9,Yelp,9,0,17,Can someone please explain to me why I should invest my money in a website like Yelp? How can a company make money off of complaints? ,"['yelp', 'can', 'someon', 'pleas', 'explain', 'i', 'invest', 'money', 'websit', 'like', 'yelp', '?', 'how', 'compani', 'make', 'money', 'complaint', '?']",[0 0 0 ... 0 0 0],10
631,5,Fibonacci Fan (for support and resistance),7,2,3,,"['fibonacci', 'fan', '(', 'support', 'resist', ')', 'nan']",[0 0 0 ... 0 0 0],5
880,4,Some Facts for Stock Market Investment,12,8,2,,"['some', 'fact', 'stock', 'market', 'invest', 'nan']",[0 0 0 ... 0 0 0],5
666,2,Consumer Confidence in U.S. Falls to Lowest Level Since 2011,6,4,1,,"['consum', 'confid', 'u.s.', 'fall', 'lowest', 'level', 'sinc', '2011', 'nan']",[0 0 0 ... 0 0 0],0
375,4,Mark's Weekly Trading Log (6/17-6/21) Charts Analysis,7,3,2,,"['mark', ""'s"", 'weekli', 'trade', 'log', '(', '6/17-6/21', ')', 'chart', 'analysi', 'nan']",[0 0 0 ... 0 0 0],5
412,5,Im going to have to do something horrible and be a little bullish here,7,2,7,,"['im', 'go', 'someth', 'horribl', 'littl', 'bullish', 'nan']",[0 0 0 ... 0 0 0],5
74,13,"Zynga folds on U.S. gambling bet, shares plummet",13,0,1,,"['zynga', 'fold', 'u.s.', 'gambl', 'bet', ',', 'share', 'plummet', 'nan']",[1 0 0 ... 0 0 0],15
113,11,Really Interesting Study on January Stock Seasonality,13,2,4,,"['realli', 'interest', 'studi', 'januari', 'stock', 'season', 'nan']",[0 0 0 ... 0 0 0],10
944,3,Do you trust the employment numbers coming out tomorrow?,5,2,3,,"['do', 'trust', 'employ', 'number', 'come', 'tomorrow', '?', 'nan']",[0 0 0 ... 0 0 0],5
557,4,Man United shares flat in debut after IPO disappoints,6,2,1,,"['man', 'unit', 'share', 'flat', 'debut', 'ipo', 'disappoint', 'nan']",[0 0 0 ... 0 0 0],5
390,6,Mark's Weekly Trading Log (4/8-4/12) Charts and Analysis,9,3,3,,"['mark', ""'s"", 'weekli', 'trade', 'log', '(', '4/8-4/12', ')', 'chart', 'analysi', 'nan']",[0 0 0 ... 0 0 0],5
104,12,"JPM -5% after hours, -$800M trade loss",12,0,7,"News breaking now, details coming out, but it sounds like somebody messed up to the tune of almost -$1B

EDIT: 

Update in:

JPMorgan Chase &amp; Co. (JPM) said it lost about $2 billion tied to synthetic credit securities after positions taken by its chief investment office were riskier than expected.

“This portfolio has proven to be riskier, more volatile and less effective as an economic hedge than the firm previously believed,” the New York-based company said today in a quarterly securities filing. JPMorgan declined 5.5 percent to $38.50 in extended trading at 4:51 p.m. in New York. 
","['jpm', '-5', '%', 'hour', ',', '-', '$', '800m', 'trade', 'loss', 'new', 'break', ',', 'detail', 'come', ',', 'sound', 'like', 'somebodi', 'mess', 'tune', 'almost', '-', '$', '1b', 'edit', ':', 'updat', ':', 'jpmorgan', 'chase', '&', 'amp', ';', 'co.', '(', 'jpm', ')', 'said', 'lost', '$', '2', 'billion', 'tie', 'synthet', 'credit', 'secur', 'posit', 'taken', 'chief', 'invest', 'offic', 'riskier', 'expect', '.', '“', 'thi', 'portfolio', 'proven', 'riskier', ',', 'volatil', 'less', 'effect', 'econom', 'hedg', 'firm', 'previous', 'believ', ',', '”', 'new', 'york-bas', 'compani', 'said', 'today', 'quarterli', 'secur', 'file', '.', 'jpmorgan', 'declin', '5.5', 'percent', '$', '38.50', 'extend', 'trade', '4:51', 'p.m.', 'new', 'york', '.']",[5 3 0 ... 0 0 0],10
114,13,This man is leading our Stock Markets? Better call Batman...,15,2,5,,"['thi', 'man', 'lead', 'stock', 'market', '?', 'better', 'call', 'batman', '...', 'nan']",[0 0 0 ... 0 0 0],15
417,5,"Wall Street Breakfast: Must-Know News November 5, 2012",7,2,0,,"['wall', 'street', 'breakfast', ':', 'must-know', 'new', 'novemb', '5', ',', '2012', 'nan']",[1 0 0 ... 0 0 0],5
464,6,GRPN -11%. Here come the downgrades,6,0,5,"I dont get this price target from Merrill. The stock gets hit from $19 to $16, but they give it a $20 target?


Groupon (GRPN) was downgraded from Buy to Neutral at Bank of America/Merrill Lynch. Restatement undermines investor confidence, BofA/Merrill said. $20 price target.
","['grpn', '-11', '%', '.', 'here', 'come', 'downgrad', 'i', 'dont', 'get', 'price', 'target', 'merril', '.', 'the', 'stock', 'get', 'hit', '$', '19', '$', '16', ',', 'give', '$', '20', 'target', '?', 'groupon', '(', 'grpn', ')', 'downgrad', 'buy', 'neutral', 'bank', 'america/merril', 'lynch', '.', 'restat', 'undermin', 'investor', 'confid', ',', 'bofa/merril', 'said', '.', '$', '20', 'price', 'target', '.']",[2 5 0 ... 0 0 0],5
457,5,"Closed a 2nd EURUSD short, with chart and reasoning",6,1,4,"I took a second position yesterday at 16:11 when EURUSD was at 1.3050.  http://www.hotstockmarket.com/t/39353/eur-usd/5700#post_2858716

The bounce was fizzling out and the EUR could not get over 1.3065, I took the position with a stop just above the resistance levels from Fridays gap.

That sellers started taking control again in the evening and are still pushing lower at the moment, but I closed up that trade here. Im interested to see what kind of action we get below 1.30 again.

Chart showing the trade:

https://www.tradingview.com/x/QTy7ip8y/

","['close', '2nd', 'eurusd', 'short', ',', 'chart', 'reason', 'i', 'took', 'second', 'posit', 'yesterday', '16:11', 'eurusd', '1.3050.', 'http', ':', '//www.hotstockmarket.com/t/39353/eur-usd/5700', '#', 'post_2858716', 'the', 'bounc', 'fizzl', 'eur', 'could', 'get', '1.3065', ',', 'i', 'took', 'posit', 'stop', 'resist', 'level', 'friday', 'gap', '.', 'that', 'seller', 'start', 'take', 'control', 'even', 'still', 'push', 'lower', 'moment', ',', 'i', 'close', 'trade', '.', 'im', 'interest', 'see', 'kind', 'action', 'get', '1.30', '.', 'chart', 'show', 'trade', ':', 'http', ':', '//www.tradingview.com/x/qty7ip8y/']",[3 3 0 ... 0 0 0],5
409,7,US Housing May Just Continue to Run « VR View,8,1,0,,"['us', 'hous', 'may', 'just', 'continu', 'run', '«', 'vr', 'view', 'nan']",[0 0 0 ... 0 0 0],5
92,10,Stock Market Analysis for week ending May 31st,14,4,1,,"['stock', 'market', 'analysi', 'week', 'end', 'may', '31st', 'nan']",[0 0 0 ... 0 0 0],10
913,4,CVTI breaking out above channel?,5,1,2,"[source](http://www.finviz.com/quote.ashx?t=cvti&amp;ty=c&amp;ta=1&amp;p=d)

Earnings release expected for end of the month.  Pretty big move in the past few weeks, plus breakout above channel.  This is a micro cap, so its fairly immune to S&amp;P/Nasdaq moves.  Could be a good play  during this turbulent month.","['cvti', 'break', 'channel', '?', '[', 'sourc', ']', '(', 'http', ':', '//www.finviz.com/quote.ashx', '?', 't=cvti', '&', 'amp', ';', 'ty=c', '&', 'amp', ';', 'ta=1', '&', 'amp', ';', 'p=d', ')', 'earn', 'releas', 'expect', 'end', 'month', '.', 'pretti', 'big', 'move', 'past', 'week', ',', 'plu', 'breakout', 'channel', '.', 'thi', 'micro', 'cap', ',', 'fairli', 'immun', 's', '&', 'amp', ';', 'p/nasdaq', 'move', '.', 'could', 'good', 'play', 'turbul', 'month', '.']",[2 4 0 ... 0 0 0],5
89,12,"Technical Tuesdays (X post r/investing) TSLA, AAPL, Gold",13,1,9,,"['technic', 'tuesday', '(', 'x', 'post', 'r/invest', ')', 'tsla', ',', 'aapl', ',', 'gold', 'nan']",[2 0 0 ... 0 0 0],10
336,6,"FB - 8%, waiting for flush",9,3,9,"Bearish sentiment is rampant with FB here, everybody talking about how horrible it is, nobody saying anything about the long side.

-8% currently at $29, Im watching volume to see if there is a flush to the downside that might indicate a bottom of some sort.

","['fb', '-', '8', '%', ',', 'wait', 'flush', 'bearish', 'sentiment', 'rampant', 'fb', ',', 'everybodi', 'talk', 'horribl', ',', 'nobodi', 'say', 'anyth', 'long', 'side', '.', '-8', '%', 'current', '$', '29', ',', 'im', 'watch', 'volum', 'see', 'flush', 'downsid', 'might', 'indic', 'bottom', 'sort', '.']",[4 2 0 ... 0 0 0],5
983,3,"Without AAPL, Q4 S&amp;P growth would be 2.9%",3,0,2,"Talk about breadth being thin...

""Were Apple’s results stripped out, Barclays Capital estimates earnings growth at S&amp;P 500 companies that have reported fourth-quarter results would be 2.9 per cent rather than 7 per cent. ""

http://www.ft.com/intl/cms/s/2/242a84f6-5657-11e1-8dfa-00144feabdc0.html#axzz1mMUSMacM","['without', 'aapl', ',', 'q4', 's', '&', 'amp', ';', 'p', 'growth', 'would', '2.9', '%', 'talk', 'breadth', 'thin', '...', ""''"", 'were', 'appl', '’', 'result', 'strip', ',', 'barclay', 'capit', 'estim', 'earn', 'growth', 's', '&', 'amp', ';', 'p', '500', 'compani', 'report', 'fourth-quart', 'result', 'would', '2.9', 'per', 'cent', 'rather', '7', 'per', 'cent.', '``', 'http', ':', '//www.ft.com/intl/cms/s/2/242a84f6-5657-11e1-8dfa-00144feabdc0.html', '#', 'axzz1mmusmacm']",[2 0 0 ... 0 0 0],5
916,3,Markets surge on European summit news,3,0,1,,"['market', 'surg', 'european', 'summit', 'news', 'nan']",[0 0 0 ... 0 0 0],5
928,3,Stock Market Today: June 11th,4,1,0,"The overnight news about Spain is being faded as the market pulls back to Fridays levels. At 10:40 here are the biggest percentage movers:

NOIZ	Micronetics Inc	14.60	94.93%

ZAZA(E)	ZaZa Energy Corp	4.27	31.38%

INMD	IntegraMed America	13.67	20.55%

AMPE	Ampio Pharmaceuticals Inc	3.68	15.00%

GFA	GAFISA SA	2.60	8.33%

ZLCS	Zalicus, Inc.	1.35	7.03%

KGJI	Kingold Jewelry Inc	2.62	6.94%

GV	Goldfield Corp	2.03	6.84%

UNIS	Unilife Corporation	5.00	6.64%

ARNA	Arena Pharmaceuticals	7.00	5.74%

","['stock', 'market', 'today', ':', 'june', '11th', 'the', 'overnight', 'news', 'spain', 'fade', 'market', 'pull', 'back', 'friday', 'level', '.', 'at', '10:40', 'biggest', 'percentag', 'mover', ':', 'noiz', 'micronet', 'inc', '14.60', '94.93', '%', 'zaza', '(', 'e', ')', 'zaza', 'energi', 'corp', '4.27', '31.38', '%', 'inmd', 'integram', 'america', '13.67', '20.55', '%', 'amp', 'ampio', 'pharmaceut', 'inc', '3.68', '15.00', '%', 'gfa', 'gafisa', 'sa', '2.60', '8.33', '%', 'zlc', 'zalicu', ',', 'inc.', '1.35', '7.03', '%', 'kgji', 'kingold', 'jewelri', 'inc', '2.62', '6.94', '%', 'gv', 'goldfield', 'corp', '2.03', '6.84', '%', 'uni', 'unilif', 'corpor', '5.00', '6.64', '%', 'arna', 'arena', 'pharmaceut', '7.00', '5.74', '%']",[1 1 0 ... 0 0 0],5
602,4,"EWP - Spain ETF, watch the horror unfold :)",5,1,7,"EWP is the iShares Spain Index, now breaking down to 2009 levels.

http://finviz.com/chart.ashx?t=EWP&amp;ty=c&amp;ta=1&amp;p=d&amp;s=l","['ewp', '-', 'spain', 'etf', ',', 'watch', 'horror', 'unfold', ':', ')', 'ewp', 'ishar', 'spain', 'index', ',', 'break', '2009', 'level', '.', 'http', ':', '//finviz.com/chart.ashx', '?', 't=ewp', '&', 'amp', ';', 'ty=c', '&', 'amp', ';', 'ta=1', '&', 'amp', ';', 'p=d', '&', 'amp', ';', 's=l']",[2 1 0 ... 0 0 0],5
590,5,Biggest % movers May 25,5,0,0,"Hi guys!

I was away all week, emergency trip, didnt get online much so Ive got a lot of catching up to do.

For Friday 25th, here are the biggest % movers in the first hour of trading:

GNOM	Complete Genomics Inc	3.03	30.04%

PACB	Pacific Biosciences of Cal Inc	2.82	17.50%

KMI.W*	Kinder Morgan Inc Wrnt W/I	1.93	12.87%

FRO	Frontline Ltd	5.58	12.05%

DGI	DigitalGlobe Inc	17.20	9.62%

NEPT	Neptune Tech &amp; Bioresources	3.77	8.33%

RUE	rue21 Inc	29.24	8.30%

GEOY	GeoEye Inc	20.50	7.30%

SCSS	Select Comfort	28.46	7.11%

TPX	Tempur-Pedic Intl	50.38	6.96%

","['biggest', '%', 'mover', 'may', '25', 'hi', 'guy', '!', 'i', 'away', 'week', ',', 'emerg', 'trip', ',', 'didnt', 'get', 'onlin', 'much', 'ive', 'got', 'lot', 'catch', '.', 'for', 'friday', '25th', ',', 'biggest', '%', 'mover', 'first', 'hour', 'trade', ':', 'gnom', 'complet', 'genom', 'inc', '3.03', '30.04', '%', 'pacb', 'pacif', 'bioscienc', 'cal', 'inc', '2.82', '17.50', '%', 'kmi.w', '*', 'kinder', 'morgan', 'inc', 'wrnt', 'w/i', '1.93', '12.87', '%', 'fro', 'frontlin', 'ltd', '5.58', '12.05', '%', 'dgi', 'digitalglob', 'inc', '17.20', '9.62', '%', 'nept', 'neptun', 'tech', '&', 'amp', ';', 'bioresourc', '3.77', '8.33', '%', 'rue', 'rue21', 'inc', '29.24', '8.30', '%', 'geoy', 'geoey', 'inc', '20.50', '7.30', '%', 'scss', 'select', 'comfort', '28.46', '7.11', '%', 'tpx', 'tempur-ped', 'intl', '50.38', '6.96', '%']",[3 1 0 ... 0 0 0],5
630,4,"""Capitalism is broken"" - Larry Summers (CNBC Vid)",5,1,0,,"['``', 'capit', 'broken', ""''"", '-', 'larri', 'summer', '(', 'cnbc', 'vid', ')', 'nan']",[0 0 0 ... 0 0 0],5
94,12,"Stock market bulls face an inconvenient truth as they celebrate the stock market’s new all-time highs - when you take inflation into account, the stock market is not at an all-time high. It’s not even close.",17,5,8,,"['stock', 'market', 'bull', 'face', 'inconveni', 'truth', 'celebr', 'stock', 'market', '’', 'new', 'all-tim', 'high', '-', 'take', 'inflat', 'account', ',', 'stock', 'market', 'all-tim', 'high', '.', 'it', '’', 'even', 'close', '.', 'nan']",[1 2 0 ... 0 0 0],10
11,25,Cramer speaks about how he manipulated the market.,31,6,12,,"['cramer', 'speak', 'manipul', 'market', '.', 'nan']",[0 1 0 ... 0 0 0],25
396,7,Mark's Weekly Trading Log Special Month End Edition (2/25-3/1) Charts and Analysis,9,2,0,,"['mark', ""'s"", 'weekli', 'trade', 'log', 'special', 'month', 'end', 'edit', '(', '2/25-3/1', ')', 'chart', 'analysi', 'nan']",[0 0 0 ... 0 0 0],5
530,3,"Help a high school student, please",7,4,20,"Okay, to start off, I am not trading with real money. In my economics class the teacher decided that we should trade stock. My teacher found a website that made a game using the real stock market to invest and each student has $100,000 to invest, currently I have $74,946. My plan was to buy stock in companies that would be selling a lot of products with Christmas coming. I invested in Apple, Microsoft, Nintendo, and Activision so far. Is this a solid plan to be going with for now? The only way to gain money is to have your stock price increase and sell it for a higher rate and we can't but stock under $2.00 and the game lasts until early January. Any advice for me? Thank You for any advice or tips you guys can give me?","['help', 'high', 'school', 'student', ',', 'pleas', 'okay', ',', 'start', ',', 'i', 'trade', 'real', 'money', '.', 'in', 'econom', 'class', 'teacher', 'decid', 'trade', 'stock', '.', 'my', 'teacher', 'found', 'websit', 'made', 'game', 'use', 'real', 'stock', 'market', 'invest', 'student', '$', '100,000', 'invest', ',', 'current', 'i', '$', '74,946', '.', 'my', 'plan', 'buy', 'stock', 'compani', 'would', 'sell', 'lot', 'product', 'christma', 'come', '.', 'i', 'invest', 'appl', ',', 'microsoft', ',', 'nintendo', ',', 'activis', 'far', '.', 'is', 'solid', 'plan', 'go', '?', 'the', 'way', 'gain', 'money', 'stock', 'price', 'increas', 'sell', 'higher', 'rate', 'ca', ""n't"", 'stock', '$', '2.00', 'game', 'last', 'earli', 'januari', '.', 'ani', 'advic', '?', 'thank', 'you', 'advic', 'tip', 'guy', 'give', '?']",[7 6 0 ... 0 0 0],5
43,17,My Thoughts on AAPL With Math.,19,2,22,,"['my', 'thought', 'aapl', 'with', 'math', '.', 'nan']",[0 1 0 ... 0 0 0],15
42,15,/r/StockMarket IRC is here!,19,4,11,"With the help of jcao219 and StockJock-e, we were able to setup a IRC channel fairly quickly last night. jcao219 comes from /r/IRC, and has offered his help us with setting up and maintaining the channel. You can find a link the IRC channel on the side bar on the right hand side, or [click here](http://webchat.freenode.net/?channels=%23reddit-stockmarket). 



**Registering**

If you're not familiar with IRC, you can post questions here and jcao will answer them. You will first need to register on the channel. [Here](http://www.deepspace.org/nickserv.htm) are some commands that will help you get setup.  



**Purpose**

The purpose for this channel is to discuss daily trading ideas/news throughout trading hours. All general questions/thoughts should be posted on /r/stockmarket. To be clear, we don't want this channel to turn into /r/investing ""Hey, I'm new to investing, what does shorting a stock mean?"". Not to down play /r/investing, but the channel should only be used for trading ideas and news only.

Also, Jcao is working on a marketbot thats pretty impressive. If you see him testing out his code on the channel, feel free to ignore. 



**Moderators**

Jcao and I will be moderating the channel. We will be on 99% of the time. The moderators of /r/stockmarket will also have admin control.



If anyone has any questions or suggestions, feel free to post. This channel is still a major work in progress, so all input is appreciated. I look forward to seeing you all there.","['/r/stockmarket', 'irc', '!', 'with', 'help', 'jcao219', 'stockjock-', ',', 'abl', 'setup', 'irc', 'channel', 'fairli', 'quickli', 'last', 'night', '.', 'jcao219', 'come', '/r/irc', ',', 'offer', 'help', 'us', 'set', 'maintain', 'channel', '.', 'you', 'find', 'link', 'irc', 'channel', 'side', 'bar', 'right', 'hand', 'side', ',', '[', 'click', ']', '(', 'http', ':', '//webchat.freenode.net/', '?', 'channels=', '%', '23reddit-stockmarket', ')', '.', '*', '*', 'regist', '*', '*', 'if', ""'re"", 'familiar', 'irc', ',', 'post', 'question', 'jcao', 'answer', '.', 'you', 'first', 'need', 'regist', 'channel', '.', '[', 'here', ']', '(', 'http', ':', '//www.deepspace.org/nickserv.htm', ')', 'command', 'help', 'get', 'setup', '.', '*', '*', 'purpos', '*', '*', 'the', 'purpos', 'channel', 'discuss', 'daili', 'trade', 'ideas/new', 'throughout', 'trade', 'hour', '.', 'all', 'gener', 'questions/thought', 'post', '/r/stockmarket', '.', 'to', 'clear', ',', ""n't"", 'want', 'channel', 'turn', '/r/invest', '``', 'hey', ',', 'i', ""'m"", 'new', 'invest', ',', 'short', 'stock', 'mean', '?', ""''"", '.', 'not', 'play', '/r/invest', ',', 'channel', 'use', 'trade', 'idea', 'news', '.', 'also', ',', 'jcao', 'work', 'marketbot', 'that', 'pretti', 'impress', '.', 'if', 'see', 'test', 'code', 'channel', ',', 'feel', 'free', 'ignor', '.', '*', '*', 'moder', '*', '*', 'jcao', 'i', 'moder', 'channel', '.', 'we', '99', '%', 'time', '.', 'the', 'moder', '/r/stockmarket', 'also', 'admin', 'control', '.', 'if', 'anyon', 'question', 'suggest', ',', 'feel', 'free', 'post', '.', 'thi', 'channel', 'still', 'major', 'work', 'progress', ',', 'input', 'appreci', '.', 'i', 'look', 'forward', 'see', '.']",[12 18  0 ...  0  0  0],15
329,7,"Stocks to Watch: LEN, GIS, MKC, MON, FB, AAPL, GOOG, BA, YHOO",7,0,0,,"['stock', 'watch', ':', 'len', ',', 'gi', ',', 'mkc', ',', 'mon', ',', 'fb', ',', 'aapl', ',', 'goog', ',', 'ba', ',', 'yhoo', 'nan']",[8 0 0 ... 0 0 0],5
167,9,"Joe Terranova says gold has some room here, but another -25% drop before year end.",11,2,19,,"['joe', 'terranova', 'say', 'gold', 'room', ',', 'anoth', '-25', '%', 'drop', 'year', 'end', '.', 'nan']",[1 1 0 ... 0 0 0],10
889,2,IMAX: The Bear Case Just Doesn't Add Up,3,1,2,,"['imax', ':', 'the', 'bear', 'case', 'just', 'doe', ""n't"", 'add', 'up', 'nan']",[0 0 0 ... 0 0 0],0
912,3,"JCP Q2 looking bad, stock down -5%",3,0,3,,"['jcp', 'q2', 'look', 'bad', ',', 'stock', '-5', '%', 'nan']",[1 0 0 ... 0 0 0],5
594,6,Biggest % gainers  May 15,6,0,0,"In the first 20min of trading on May 15th, here are the biggest % gainers:

OPNT	Opnet Technologies	27.54	24.56%

GRPN	Groupon Inc Class A	13.90	18.45%

RENN	Renren Inc	6.12	11.48%

CVO	Cenveo Inc	2.01	8.97%

AMED	Amedisys Inc	11.00	8.16%

CSOD	Cornerstone OnDemand Inc	19.75	7.86%

TJX	TJX Companies	42.29	6.52%

UGAZ	VS 3x Long Natural Gas ETN	26.20	6.50%

DKS	Dick's Sporting Goods	50.31	6.50%

VOXX	VOXX Int'l Corp. Cl A	12.45	6.23%

","['biggest', '%', 'gainer', 'may', '15', 'in', 'first', '20min', 'trade', 'may', '15th', ',', 'biggest', '%', 'gainer', ':', 'opnt', 'opnet', 'technolog', '27.54', '24.56', '%', 'grpn', 'groupon', 'inc', 'class', 'a', '13.90', '18.45', '%', 'renn', 'renren', 'inc', '6.12', '11.48', '%', 'cvo', 'cenveo', 'inc', '2.01', '8.97', '%', 'ame', 'amedisi', 'inc', '11.00', '8.16', '%', 'csod', 'cornerston', 'ondemand', 'inc', '19.75', '7.86', '%', 'tjx', 'tjx', 'compani', '42.29', '6.52', '%', 'ugaz', 'vs', '3x', 'long', 'natur', 'ga', 'etn', '26.20', '6.50', '%', 'dk', 'dick', ""'s"", 'sport', 'good', '50.31', '6.50', '%', 'voxx', 'voxx', 'int', ""'"", 'l', 'corp.', 'cl', 'a', '12.45', '6.23', '%']",[1 0 0 ... 0 0 0],5
752,4,Biggest % movers May 16,4,0,0,"Into the first hour of trading, here are the biggest movers:

ROSG(F)	Rosetta Genomics Ltd	4.88	201.23%

OSUR	Orasure Technologies	11.52	26.59%

SINA	Sina Corp	58.39	12.98%

COGO	Cogo Group Inc	2.25	12.50%

KITD	KIT digital Inc	4.62	10.79%

GALE	Galena Biopharma Inc	1.23	9.82%

CTRN	Citi Trends Inc	13.33	9.44%

THLD	Threshold Pharmaceuticals Inc	6.99	8.37%

MSPD	Mindspeed Technologies Inc	3.62	7.96%

JAG	Jaguar Mining Inc Ord Shs	1.37	7.87%

","['biggest', '%', 'mover', 'may', '16', 'into', 'first', 'hour', 'trade', ',', 'biggest', 'mover', ':', 'rosg', '(', 'f', ')', 'rosetta', 'genom', 'ltd', '4.88', '201.23', '%', 'osur', 'orasur', 'technolog', '11.52', '26.59', '%', 'sina', 'sina', 'corp', '58.39', '12.98', '%', 'cogo', 'cogo', 'group', 'inc', '2.25', '12.50', '%', 'kitd', 'kit', 'digit', 'inc', '4.62', '10.79', '%', 'gale', 'galena', 'biopharma', 'inc', '1.23', '9.82', '%', 'ctrn', 'citi', 'trend', 'inc', '13.33', '9.44', '%', 'thld', 'threshold', 'pharmaceut', 'inc', '6.99', '8.37', '%', 'mspd', 'mindspe', 'technolog', 'inc', '3.62', '7.96', '%', 'jag', 'jaguar', 'mine', 'inc', 'ord', 'sh', '1.37', '7.87', '%']",[1 0 0 ... 0 0 0],5
100,12,Netflix Rally Halted After BofA Downgrade,13,1,2,,"['netflix', 'ralli', 'halt', 'after', 'bofa', 'downgrad', 'nan']",[0 0 0 ... 0 0 0],10
426,8,Top 10 movers Aug 31,8,0,13,"EDIT its Aug 30 obviously, my flux capacitor was acting up today.

As of 12:30 lunch time, these are the biggest % movers:

FSR	Flagstone Reinsur Hldgs Ltd	8.55	21.10%

STEM	StemCells Inc	1.93	19.88%

P	Pandora Media Inc	11.99	18.95%

BPT	BP Prudhoe Bay Royalty	88.68	15.51%

SRPT	Sarepta Therapeutics Inc	14.21	12.78%

GEF	Greif Inc 'A'	44.54	9.43%

GERN	Geron Corp	2.62	8.72%

VC	Visteon Corporation	46.01	8.39%

RPRX	Repros Therapeutics Inc	12.32	8.16%

UGAZ	VS 3x Long Natural Gas ETN	22.88	6.77%

","['top', '10', 'mover', 'aug', '31', 'edit', 'aug', '30', 'obvious', ',', 'flux', 'capacitor', 'act', 'today', '.', 'as', '12:30', 'lunch', 'time', ',', 'biggest', '%', 'mover', ':', 'fsr', 'flagston', 'reinsur', 'hldg', 'ltd', '8.55', '21.10', '%', 'stem', 'stemcel', 'inc', '1.93', '19.88', '%', 'p', 'pandora', 'media', 'inc', '11.99', '18.95', '%', 'bpt', 'bp', 'prudho', 'bay', 'royalti', '88.68', '15.51', '%', 'srpt', 'sarepta', 'therapeut', 'inc', '14.21', '12.78', '%', 'gef', 'greif', 'inc', ""'"", ""a'"", '44.54', '9.43', '%', 'gern', 'geron', 'corp', '2.62', '8.72', '%', 'vc', 'visteon', 'corpor', '46.01', '8.39', '%', 'rprx', 'repro', 'therapeut', 'inc', '12.32', '8.16', '%', 'ugaz', 'vs', '3x', 'long', 'natur', 'ga', 'etn', '22.88', '6.77', '%']",[2 1 0 ... 0 0 0],10
178,8,Technical Tuesday: Stocks coming off lows with RSI going above 20,9,1,9,"Running some simply scans looking for possible bounce plays:

RSI &gt; 20
Avg 90 day volume greater than 100,000

This is not a recommendation to buy these stocks, just a result of a quick scan.

    Symbol	Last	Chg(%)	Vol
    ANV	15.53	31.72	7390491
    SABA	7.22	9.23	2759465
    LFL	21.19	1.83	534298
    RDWR	29.58	2.71	345188
    PKX	69.7	1.22	249421
","['technic', 'tuesday', ':', 'stock', 'come', 'low', 'rsi', 'go', '20', 'run', 'simpli', 'scan', 'look', 'possibl', 'bounc', 'play', ':', 'rsi', '&', 'gt', ';', '20', 'avg', '90', 'day', 'volum', 'greater', '100,000', 'thi', 'recommend', 'buy', 'stock', ',', 'result', 'quick', 'scan', '.', 'symbol', 'last', 'chg', '(', '%', ')', 'vol', 'anv', '15.53', '31.72', '7390491', 'saba', '7.22', '9.23', '2759465', 'lfl', '21.19', '1.83', '534298', 'rdwr', '29.58', '2.71', '345188', 'pkx', '69.7', '1.22', '249421']",[1 1 0 ... 0 0 0],10
444,4,RIMM -17% to $7.52,7,3,15,"RIM earnings are in, everything sucks. 

Looks like the spiral down the drain continues.","['rimm', '-17', '%', '$', '7.52', 'rim', 'earn', ',', 'everyth', 'suck', '.', 'look', 'like', 'spiral', 'drain', 'continu', '.']",[1 2 0 ... 0 0 0],5
416,7,Why does the stock market matter?,8,1,6,I know the basics of the stock market of how it works. But I don't know why. How are the stock market and economy intertwined and why does a booming stock market usually indicate a booming economy?,"['whi', 'stock', 'market', 'matter', '?', 'i', 'know', 'basic', 'stock', 'market', 'work', '.', 'but', 'i', ""n't"", 'know', '.', 'how', 'stock', 'market', 'economi', 'intertwin', 'boom', 'stock', 'market', 'usual', 'indic', 'boom', 'economi', '?']",[0 2 0 ... 0 0 0],5
644,5,"Stock 'fear gauge' flawed, Citi equity trading chief says",7,2,3,,"['stock', ""'fear"", 'gaug', ""'"", 'flaw', ',', 'citi', 'equiti', 'trade', 'chief', 'say', 'nan']",[1 0 0 ... 0 0 0],5
877,2,Tips for my FIRST ever trade?,7,5,15,"So - I've been reading about the stock market and day/swing/options trading for months now. I finally think I'm ready to bite the bullet, fund a brokerage account, and start looking for trades I like. 
I guess I just want to ping the more advanced traders here as to what they would have loved to know, or would have loved to do their first trade. There's no other way to it but to do it, but I'd like to be as ready for my first trade as possible when the time does come. 
All insight and help is greatly appreciated! Thanks!","['tip', 'first', 'ever', 'trade', '?', 'so', '-', 'i', ""'ve"", 'read', 'stock', 'market', 'day/swing/opt', 'trade', 'month', '.', 'i', 'final', 'think', 'i', ""'m"", 'readi', 'bite', 'bullet', ',', 'fund', 'brokerag', 'account', ',', 'start', 'look', 'trade', 'i', 'like', '.', 'i', 'guess', 'i', 'want', 'ping', 'advanc', 'trader', 'would', 'love', 'know', ',', 'would', 'love', 'first', 'trade', '.', 'there', ""'s"", 'way', ',', 'i', ""'d"", 'like', 'readi', 'first', 'trade', 'possibl', 'time', 'come', '.', 'all', 'insight', 'help', 'greatli', 'appreci', '!', 'thank', '!']",[4 4 0 ... 0 0 0],0
655,4,Anyone daytrade spy options?,5,1,15,"just wondering if this is a viable strategy. Mainly, is there any slippage when buying or selling spy options calls and puts? I've tried paper trading the highest volume calls but I never seem to get in  on market orders in thinkorswim paper trades. 

Am I missing something?



","['anyon', 'daytrad', 'spi', 'option', '?', 'wonder', 'viabl', 'strategi', '.', 'mainli', ',', 'slippag', 'buy', 'sell', 'spi', 'option', 'call', 'put', '?', 'i', ""'ve"", 'tri', 'paper', 'trade', 'highest', 'volum', 'call', 'i', 'never', 'seem', 'get', 'market', 'order', 'thinkorswim', 'paper', 'trade', '.', 'am', 'i', 'miss', 'someth', '?']",[1 2 0 ... 0 0 0],5
177,8,Bank of America tops Dow gainers,18,10,0,,"['bank', 'america', 'top', 'dow', 'gainer', 'nan']",[0 0 0 ... 0 0 0],10
395,6,"Dow, S&amp;P Log 7-Day Win Streak; Dow Extends All-Time High",6,0,1,,"['dow', ',', 's', '&', 'amp', ';', 'p', 'log', '7-day', 'win', 'streak', ';', 'dow', 'extend', 'all-tim', 'high', 'nan']",[1 0 0 ... 0 0 0],5
672,3,Help! I need advice for my Dad who wants to be a trader. ,7,4,14,"My dad was recently let go from his job and _just_ heard about online trading of stocks. Literally just learned about the term bull market., etc. He was at a barber shop and said some guy was raving about how he makes so much money every day with it. Now my dad wants to do it. He is a very naive individual and absolutely does not know a thing about it, but is now considering it as Plan A instead of getting a job. Like, this is embarrassing to even ask because you would think that an older adult would have enough common sense not to think like this. So, please, can anyone provide some explanations that may show the reality of trading and how easily and badly you can get hurt? Especially someone who nows absolutely nothing about it.","['help', '!', 'i', 'need', 'advic', 'dad', 'want', 'trader', '.', 'my', 'dad', 'recent', 'let', 'go', 'job', '_just_', 'heard', 'onlin', 'trade', 'stock', '.', 'liter', 'learn', 'term', 'bull', 'market.', ',', 'etc', '.', 'he', 'barber', 'shop', 'said', 'guy', 'rave', 'make', 'much', 'money', 'everi', 'day', '.', 'now', 'dad', 'want', '.', 'he', 'naiv', 'individu', 'absolut', 'know', 'thing', ',', 'consid', 'plan', 'a', 'instead', 'get', 'job', '.', 'like', ',', 'embarrass', 'even', 'ask', 'would', 'think', 'older', 'adult', 'would', 'enough', 'common', 'sens', 'think', 'like', '.', 'so', ',', 'pleas', ',', 'anyon', 'provid', 'explan', 'may', 'show', 'realiti', 'trade', 'easili', 'badli', 'get', 'hurt', '?', 'especi', 'someon', 'now', 'absolut', 'noth', '.']",[5 8 0 ... 0 0 0],5
789,4,References / help for new stock traders.,4,0,5,"I'm looking to get into trading, but have BARELY any knowledge of the intricate workings of the financial system or the stock market.  

Where do you begin? Are there any good resources, books, sites, help topics for people like me?

How did you get your start?","['refer', '/', 'help', 'new', 'stock', 'trader', '.', 'i', ""'m"", 'look', 'get', 'trade', ',', 'bare', 'knowledg', 'intric', 'work', 'financi', 'system', 'stock', 'market', '.', 'where', 'begin', '?', 'are', 'good', 'resourc', ',', 'book', ',', 'site', ',', 'help', 'topic', 'peopl', 'like', '?', 'how', 'get', 'start', '?']",[4 2 0 ... 0 0 0],5
965,3,"JVA on day 3 of its run, +100% move",3,0,0,"JVA had a big gap higher off the $7 area on Friday on good earnings to the $11 resistance area. Then on Monday it did another +20% and today its at $14.35.

http://finviz.com/quote.ashx?t=jva","['jva', 'day', '3', 'run', ',', '+100', '%', 'move', 'jva', 'big', 'gap', 'higher', '$', '7', 'area', 'friday', 'good', 'earn', '$', '11', 'resist', 'area', '.', 'then', 'monday', 'anoth', '+20', '%', 'today', '$', '14.35', '.', 'http', ':', '//finviz.com/quote.ashx', '?', 't=jva']",[1 2 0 ... 0 0 0],5
680,4,DD - DuPont -8% on earnings hit,4,0,0,"&gt; DuPont DD -8.62% led nearly all 30 of the of the Dow's components lower after the diversified manufacturer posted weaker-than-expected results. Its third-quarter revenue missed expectations and the company trimmed its full-year earnings outlook, while also revealing a restructuring plan that is to include a reduction of 1,500 jobs. DuPont's tumble, should it hold, would rank among the top-five biggest single-day drops for a Dow component this year.

Shares of 3M slid after the blue-chip industrial conglomerate reported third-quarter revenue that fell short of expectations, and lowered its full-year earnings outlook. - WSJ","['dd', '-', 'dupont', '-8', '%', 'earn', 'hit', '&', 'gt', ';', 'dupont', 'dd', '-8.62', '%', 'led', 'nearli', '30', 'dow', ""'s"", 'compon', 'lower', 'diversifi', 'manufactur', 'post', 'weaker-than-expect', 'result', '.', 'it', 'third-quart', 'revenu', 'miss', 'expect', 'compani', 'trim', 'full-year', 'earn', 'outlook', ',', 'also', 'reveal', 'restructur', 'plan', 'includ', 'reduct', '1,500', 'job', '.', 'dupont', ""'s"", 'tumbl', ',', 'hold', ',', 'would', 'rank', 'among', 'top-fiv', 'biggest', 'single-day', 'drop', 'dow', 'compon', 'year', '.', 'share', '3m', 'slid', 'blue-chip', 'industri', 'conglomer', 'report', 'third-quart', 'revenu', 'fell', 'short', 'expect', ',', 'lower', 'full-year', 'earn', 'outlook', '.', '-', 'wsj']",[4 4 0 ... 0 0 0],5
383,6,Help me analyze what happened with this options trade?,6,0,22,"I'm fairly new to options trading, but I've done my reading and understand at least the basic concepts involved.  I've been steadily losing money paper trading options due to one stupid mistake or another (and learning along the way).  

On Friday, May 24th, I correctly predicted a small intraday movement downwards in IBM, and bought Put contracts hoping to profit from the move.  However, even though the stock moved down as I expected, the value of my Put contracts actually went down instead of up!  Instead of taking a 4% profit, I took a 4% loss.  Here's the trades I made:

Buy 27 Jun 2013 200-strike Puts, filled for $1.61 (or $161 per 100 shares) at 12:33pm (IBM was $205.79 at the time, and the contract spread was $0.03)

Sell 27 Jun 2013 200-strike Puts, filled for $1.56 at 3:24pm (IBM was $205.51 at the time, and the spread was still $0.03)

Between the time I bought and sold, the implied volatility stayed roughly the same (changed from 16.7 to about 16.3, as reported by my trading platform), and the delta also remained the same (-27).

I've been trying to figure out how the Put could have moved down 8% lower than I was expecting.  Surely the time decay couldn't account for that steep of a drop in a mere three hours?  

Doing the math, here's what I expected:

(205.79 - 205.51) * 0.27 = 0.0756 expected gain in Put price


0.0756 + 1.61 = 1.68 expected value of contracts at sell time


(1.68 / 1.61) - 1 = 4.69% expected gain in Put price

What happened instead is that I had to sell for $1.56, which makes no sense to me.  Here's the [IBM chart with relevant parts shown](http://i.imgur.com/auEgWJx.png).
","['help', 'analyz', 'happen', 'option', 'trade', '?', 'i', ""'m"", 'fairli', 'new', 'option', 'trade', ',', 'i', ""'ve"", 'done', 'read', 'understand', 'least', 'basic', 'concept', 'involv', '.', 'i', ""'ve"", 'steadili', 'lose', 'money', 'paper', 'trade', 'option', 'due', 'one', 'stupid', 'mistak', 'anoth', '(', 'learn', 'along', 'way', ')', '.', 'on', 'friday', ',', 'may', '24th', ',', 'i', 'correctli', 'predict', 'small', 'intraday', 'movement', 'downward', 'ibm', ',', 'bought', 'put', 'contract', 'hope', 'profit', 'move', '.', 'howev', ',', 'even', 'though', 'stock', 'move', 'i', 'expect', ',', 'valu', 'put', 'contract', 'actual', 'went', 'instead', '!', 'instead', 'take', '4', '%', 'profit', ',', 'i', 'took', '4', '%', 'loss', '.', 'here', ""'s"", 'trade', 'i', 'made', ':', 'buy', '27', 'jun', '2013', '200-strike', 'put', ',', 'fill', '$', '1.61', '(', '$', '161', 'per', '100', 'share', ')', '12:33pm', '(', 'ibm', '$', '205.79', 'time', ',', 'contract', 'spread', '$', '0.03', ')', 'sell', '27', 'jun', '2013', '200-strike', 'put', ',', 'fill', '$', '1.56', '3:24pm', '(', 'ibm', '$', '205.51', 'time', ',', 'spread', 'still', '$', '0.03', ')', 'between', 'time', 'i', 'bought', 'sold', ',', 'impli', 'volatil', 'stay', 'roughli', '(', 'chang', '16.7', '16.3', ',', 'report', 'trade', 'platform', ')', ',', 'delta', 'also', 'remain', '(', '-27', ')', '.', 'i', ""'ve"", 'tri', 'figur', 'put', 'could', 'move', '8', '%', 'lower', 'i', 'expect', '.', 'sure', 'time', 'decay', 'could', ""n't"", 'account', 'steep', 'drop', 'mere', 'three', 'hour', '?', 'do', 'math', ',', ""'s"", 'i', 'expect', ':', '(', '205.79', '-', '205.51', ')', '*', '0.27', '=', '0.0756', 'expect', 'gain', 'put', 'price', '0.0756', '+', '1.61', '=', '1.68', 'expect', 'valu', 'contract', 'sell', 'time', '(', '1.68', '/', '1.61', ')', '-', '1', '=', '4.69', '%', 'expect', 'gain', 'put', 'price', 'what', 'happen', 'instead', 'i', 'sell', '$', '1.56', ',', 'make', 'sens', '.', 'here', ""'s"", '[', 'ibm', 'chart', 'relev', 'part', 'shown', ']', '(', 'http', ':', '//i.imgur.com/auegwjx.png', ')', '.']",[16  8  0 ...  0  0  0],5
951,3,Vix on pace for record 8th day gain.,3,0,7,,"['vix', 'pace', 'record', '8th', 'day', 'gain', '.', 'nan']",[0 1 0 ... 0 0 0],5
718,3,Stock Market July 12th top ten movers,4,1,1,"Bear ETFs making up the list of the top 10 movers as stocks open lower after the Fed fails to grace us with hints of QE yesterday.

SSH	Sunshine Heart Inc	12.93	13.32%

AFFY	Affymax, Inc	13.54	13.31%

UVXY	ProShares Ultra VIX Short-Term	8.93	8.10%

TZYM	Tranzyme Inc	4.35	7.41%

SOXS	Direxion Daily Semicon Bear 3X	49.99	7.27%

DUST	Direxion Dly Gold Miners 3X BR	59.45	7.27%

TVIX	VS 2X VIX Short Term	4.19	6.65%

EDZ	Emerging Markets Bear 3x Shs	16.44	6.27%

VHC	VirnetX Holding Corp	38.07	6.13%

TXI	Texas Industries Inc	40.37	6.08%



","['stock', 'market', 'juli', '12th', 'top', 'ten', 'mover', 'bear', 'etf', 'make', 'list', 'top', '10', 'mover', 'stock', 'open', 'lower', 'fed', 'fail', 'grace', 'us', 'hint', 'qe', 'yesterday', '.', 'ssh', 'sunshin', 'heart', 'inc', '12.93', '13.32', '%', 'affi', 'affymax', ',', 'inc', '13.54', '13.31', '%', 'uvxi', 'proshar', 'ultra', 'vix', 'short-term', '8.93', '8.10', '%', 'tzym', 'tranzym', 'inc', '4.35', '7.41', '%', 'sox', 'direxion', 'daili', 'semicon', 'bear', '3x', '49.99', '7.27', '%', 'dust', 'direxion', 'dli', 'gold', 'miner', '3x', 'br', '59.45', '7.27', '%', 'tvix', 'vs', '2x', 'vix', 'short', 'term', '4.19', '6.65', '%', 'edz', 'emerg', 'market', 'bear', '3x', 'sh', '16.44', '6.27', '%', 'vhc', 'virnetx', 'hold', 'corp', '38.07', '6.13', '%', 'txi', 'texa', 'industri', 'inc', '40.37', '6.08', '%']",[1 1 0 ... 0 0 0],5
257,9,...And Occasionally you hit a homerun...,13,4,13,,"['...', 'and', 'occasion', 'hit', 'homerun', '...', 'nan']",[0 0 0 ... 0 0 0],10
535,5,"The S&amp;P US Dollar and the FED by Mark Vierra
my first published article :)",6,1,1,,"['the', 's', '&', 'amp', ';', 'p', 'us', 'dollar', 'fed', 'mark', 'vierra', 'first', 'publish', 'articl', ':', ')', 'nan']",[0 0 0 ... 0 0 0],5
335,7,RIMM -12% warns of operating loss ,7,0,11,"Halted briefly after hours, opened now to a -12% hit.

Research In Motion Ltd. expects to post an operating loss in its first quarter, citing the challenges of lower volumes and a ""highly competitive pricing"" climate.

The BlackBerry maker also said Tuesday it has hired JPMorgan Chase &amp; Co. and RBC Capital Markets to help the company in its strategic review. 

http://www.theglobeandmail.com/globe-investor/rim-warns-of-operating-loss/article2446752/","['rimm', '-12', '%', 'warn', 'oper', 'loss', 'halt', 'briefli', 'hour', ',', 'open', '-12', '%', 'hit', '.', 'research', 'in', 'motion', 'ltd.', 'expect', 'post', 'oper', 'loss', 'first', 'quarter', ',', 'cite', 'challeng', 'lower', 'volum', '``', 'highli', 'competit', 'price', ""''"", 'climat', '.', 'the', 'blackberri', 'maker', 'also', 'said', 'tuesday', 'hire', 'jpmorgan', 'chase', '&', 'amp', ';', 'co.', 'rbc', 'capit', 'market', 'help', 'compani', 'strateg', 'review', '.', 'http', ':', '//www.theglobeandmail.com/globe-investor/rim-warns-of-operating-loss/article2446752/']",[2 3 0 ... 0 0 0],5
611,6,Big volume in GMCR puts BEFORE the SBUX news,8,2,3,"Ok, which one of you was it, and why did you not share the tip with us?! &gt;:(

http://www.reuters.com/article/2012/03/09/greenmountain-options-idUSL2E8E9EC420120309

March 9 (Reuters) - A heavy burst of bearish option action in Green Mountain Coffee Roasters Inc in the hours before Starbucks announced plans to launch a single-cup coffee and espresso brewer has raised eyebrows among some option market participants.

Option bets on a big move up in Starbucks shares and on a sharp drop in Green Mountain stock preceded the news.

""The level of aggressiveness that traders early on Thursday came for Green Mountain March downside puts was very suspicious,"" said Alan Thompson, options market maker at Timber Hill, a division of Interactive Brokers Group. ""It raised our eyebrows.""

The put buying in Green Mountain ""was off the charts into last night's announcement,"" said Jon Najarian, a co-founder of online brokerage TradeMonster in Chicago, who also noticed very strong buying of upside calls in Starbucks on Wednesday.","['big', 'volum', 'gmcr', 'put', 'befor', 'sbux', 'news', 'ok', ',', 'one', ',', 'share', 'tip', 'us', '?', '!', '&', 'gt', ';', ':', '(', 'http', ':', '//www.reuters.com/article/2012/03/09/greenmountain-options-idusl2e8e9ec420120309', 'march', '9', '(', 'reuter', ')', '-', 'a', 'heavi', 'burst', 'bearish', 'option', 'action', 'green', 'mountain', 'coffe', 'roaster', 'inc', 'hour', 'starbuck', 'announc', 'plan', 'launch', 'single-cup', 'coffe', 'espresso', 'brewer', 'rais', 'eyebrow', 'among', 'option', 'market', 'particip', '.', 'option', 'bet', 'big', 'move', 'starbuck', 'share', 'sharp', 'drop', 'green', 'mountain', 'stock', 'preced', 'news', '.', '``', 'the', 'level', 'aggress', 'trader', 'earli', 'thursday', 'came', 'green', 'mountain', 'march', 'downsid', 'put', 'suspici', ',', ""''"", 'said', 'alan', 'thompson', ',', 'option', 'market', 'maker', 'timber', 'hill', ',', 'divis', 'interact', 'broker', 'group', '.', '``', 'it', 'rais', 'eyebrow', '.', ""''"", 'the', 'put', 'buy', 'green', 'mountain', '``', 'chart', 'last', 'night', ""'s"", 'announc', ',', ""''"", 'said', 'jon', 'najarian', ',', 'co-found', 'onlin', 'brokerag', 'trademonst', 'chicago', ',', 'also', 'notic', 'strong', 'buy', 'upsid', 'call', 'starbuck', 'wednesday', '.']",[8 5 0 ... 0 0 0],5
15,27,"since 1994, more than 80% of the equity premium on US stocks has been earned over the 24 hours preceding scheduled FOMC announcements (which occur only 8 times a year)—a phenomenon we call the pre-FOMC announcement “drift.”",29,2,8,,"['sinc', '1994', ',', '80', '%', 'equiti', 'premium', 'us', 'stock', 'earn', '24', 'hour', 'preced', 'schedul', 'fomc', 'announc', '(', 'occur', '8', 'time', 'year', ')', '—a', 'phenomenon', 'call', 'pre-fomc', 'announc', '“', 'drift.', '”', 'nan']",[1 0 0 ... 0 0 0],25
3,27,Intro to technical analysis,34,7,9,"Lots of new subscribers here asking what the hell those lines are all over the charts we put up.

Here is a post I made 7yrs ago as a brief introduction to technical analysis.

It is by no means the complete guide, but rather a quick intro that explains support and resistance, some very basic oscillators and chart patterns:

http://www.hotstockmarket.com/t/27430/teach-me-technical-analysis","['intro', 'technic', 'analysi', 'lot', 'new', 'subscrib', 'ask', 'hell', 'line', 'chart', 'put', '.', 'here', 'post', 'i', 'made', '7yr', 'ago', 'brief', 'introduct', 'technic', 'analysi', '.', 'it', 'mean', 'complet', 'guid', ',', 'rather', 'quick', 'intro', 'explain', 'support', 'resist', ',', 'basic', 'oscil', 'chart', 'pattern', ':', 'http', ':', '//www.hotstockmarket.com/t/27430/teach-me-technical-analysi']",[2 2 0 ... 0 0 0],25
876,2,SMO Fitzgerald Global - Texas Instruments Forecast Revenue.,4,2,0,,"['smo', 'fitzgerald', 'global', '-', 'texa', 'instrument', 'forecast', 'revenu', '.', 'nan']",[0 1 0 ... 0 0 0],0
324,8,$IWM: Short Trade Idea setting up,9,1,1,,"['$', 'iwm', ':', 'short', 'trade', 'idea', 'set', 'nan']",[0 0 0 ... 0 0 0],10
650,3,MrTopStep Monday July1st wrap up,5,2,0,,"['mrtopstep', 'monday', 'july1st', 'wrap', 'nan']",[0 0 0 ... 0 0 0],5
256,8,Exiting my S&amp;P futures long here at 1355 from 1325,10,2,8,,"['exit', 's', '&', 'amp', ';', 'p', 'futur', 'long', '1355', '1325', 'nan']",[0 0 0 ... 0 0 0],10
542,4,"UPS Posts Lower Profit, Revenue",5,1,2,,"['up', 'post', 'lower', 'profit', ',', 'revenu', 'nan']",[1 0 0 ... 0 0 0],5
754,5,JPM down ~14% over two days; now below 200 SMA ...almost a buy?,6,1,11,,"['jpm', '~14', '%', 'two', 'day', ';', '200', 'sma', '...', 'almost', 'buy', '?', 'nan']",[0 0 0 ... 0 0 0],5
222,6,Any stock that tracks Europe as a whole?,8,2,4,"In case they rebound, just curious.","['ani', 'stock', 'track', 'europ', 'whole', '?', 'in', 'case', 'rebound', ',', 'curiou', '.']",[1 1 0 ... 0 0 0],5
179,8,$48-$49 support on RIG? Watching the chart,9,1,1,"The $48 to $49 range was resistance last year, Im watching to see if this pull back off the highs finds buyers in this range.


http://finviz.com/quote.ashx?t=rig&amp;ty=c&amp;ta=1&amp;p=d","['$', '48-', '$', '49', 'support', 'rig', '?', 'watch', 'chart', 'the', '$', '48', '$', '49', 'rang', 'resist', 'last', 'year', ',', 'im', 'watch', 'see', 'pull', 'back', 'high', 'find', 'buyer', 'rang', '.', 'http', ':', '//finviz.com/quote.ashx', '?', 't=rig', '&', 'amp', ';', 'ty=c', '&', 'amp', ';', 'ta=1', '&', 'amp', ';', 'p=d']",[1 1 0 ... 0 0 0],10
978,3,"EURUSD flirts with 1.35, lots of shorts feeling the pain",3,0,3,"Just shy of 1.35 here.

http://finviz.com/fut_chart.ashx?t=6E&amp;cot=099741&amp;p=d1

EURUSD has probably been one of the favorite shorts of the past 9 months, the problem is that when everybody is on one side of the fence, the opposite tends to happen.

Europe falling apart? Greek default? Slowing economy? No problem! EUR rally! :P","['eurusd', 'flirt', '1.35', ',', 'lot', 'short', 'feel', 'pain', 'just', 'shi', '1.35', '.', 'http', ':', '//finviz.com/fut_chart.ashx', '?', 't=6e', '&', 'amp', ';', 'cot=099741', '&', 'amp', ';', 'p=d1', 'eurusd', 'probabl', 'one', 'favorit', 'short', 'past', '9', 'month', ',', 'problem', 'everybodi', 'one', 'side', 'fenc', ',', 'opposit', 'tend', 'happen', '.', 'europ', 'fall', 'apart', '?', 'greek', 'default', '?', 'slow', 'economi', '?', 'no', 'problem', '!', 'eur', 'ralli', '!', ':', 'p']",[3 2 0 ... 0 0 0],5
22,18,Do you need to be schooled in trading to be successful? ,23,5,30,"I am an engineer and I have very little knowledge about the stock market. Can trading be self taught by trial and error, internet articles, etc., or do I actually need to be into the whole thing professionally to be successful? ","['do', 'need', 'school', 'trade', 'success', '?', 'i', 'engin', 'i', 'littl', 'knowledg', 'stock', 'market', '.', 'can', 'trade', 'self', 'taught', 'trial', 'error', ',', 'internet', 'articl', ',', 'etc.', ',', 'i', 'actual', 'need', 'whole', 'thing', 'profession', 'success', '?']",[3 1 0 ... 0 0 0],20
356,7,Wow! Now entire countries are buying AAPL!,7,0,5,,"['wow', '!', 'now', 'entir', 'countri', 'buy', 'aapl', '!', 'nan']",[0 0 0 ... 0 0 0],5
879,3,Mark's Weekly Log. Charts and Analysis.,3,0,2,,"['mark', ""'s"", 'weekli', 'log', '.', 'chart', 'analysi', '.', 'nan']",[0 2 0 ... 0 0 0],5
870,3,"Asian Markets Down, Weak Corporate Earnings Dampen Sentiments - IBTimes UK",3,0,0,,"['asian', 'market', 'down', ',', 'weak', 'corpor', 'earn', 'dampen', 'sentiment', '-', 'ibtim', 'uk', 'nan']",[1 0 0 ... 0 0 0],5
340,6,CHK -13% on cash worries,8,2,2,"WSJ - Chesapeake Energy Corp. lost more than $1 billion in stock-market value in 46 minutes of trading on Friday after the company disclosed it might be forced to delay plans to sell assets to fund its operations this year.

The beleaguered natural-gas producer spooked investors by discussing the potential delay in a quarterly regulatory filing, which had been expected to be filed a day earlier. The filing included new warnings about the possible need to delay asset deals to comply with terms of a key line of credit. Its shares dropped 13.8% to $14.81 in 4 p.m. New York Stock Exchange ...

http://finviz.com/quote.ashx?t=chk","['chk', '-13', '%', 'cash', 'worri', 'wsj', '-', 'chesapeak', 'energi', 'corp.', 'lost', '$', '1', 'billion', 'stock-market', 'valu', '46', 'minut', 'trade', 'friday', 'compani', 'disclos', 'might', 'forc', 'delay', 'plan', 'sell', 'asset', 'fund', 'oper', 'year', '.', 'the', 'beleagu', 'natural-ga', 'produc', 'spook', 'investor', 'discuss', 'potenti', 'delay', 'quarterli', 'regulatori', 'file', ',', 'expect', 'file', 'day', 'earlier', '.', 'the', 'file', 'includ', 'new', 'warn', 'possibl', 'need', 'delay', 'asset', 'deal', 'compli', 'term', 'key', 'line', 'credit', '.', 'it', 'share', 'drop', '13.8', '%', '$', '14.81', '4', 'p.m.', 'new', 'york', 'stock', 'exchang', '...', 'http', ':', '//finviz.com/quote.ashx', '?', 't=chk']",[1 3 0 ... 0 0 0],5
431,5,How?,9,4,7,"How does one go about with the actual picking of stock? What graphs, numbers, or charts do you look at? I know lots about how the stock market works, but how do you actually make the decision? Do you look at P/E etc.?","['how', '?', 'how', 'one', 'go', 'actual', 'pick', 'stock', '?', 'what', 'graph', ',', 'number', ',', 'chart', 'look', '?', 'i', 'know', 'lot', 'stock', 'market', 'work', ',', 'actual', 'make', 'decis', '?', 'do', 'look', 'p/e', 'etc', '.', '?']",[3 1 0 ... 0 0 0],5
548,4,"FedEx’s Downbeat Results: It’s the Economy, Stupid",5,1,2,,"['fedex', '’', 'downbeat', 'result', ':', 'it', '’', 'economi', ',', 'stupid', 'nan']",[1 0 0 ... 0 0 0],5
828,3,"What goes up, must come down. Nikkei takes a 7% dive!",6,3,2,"To the surprise of no technical analyst anywhere...

http://finviz.com/fut_chart.ashx?t=NKD&amp;cot=240741&amp;p=h1

You dont go from 9000 to 16000 in a straight line.","['what', 'goe', ',', 'must', 'come', '.', 'nikkei', 'take', '7', '%', 'dive', '!', 'to', 'surpris', 'technic', 'analyst', 'anywher', '...', 'http', ':', '//finviz.com/fut_chart.ashx', '?', 't=nkd', '&', 'amp', ';', 'cot=240741', '&', 'amp', ';', 'p=h1', 'you', 'dont', 'go', '9000', '16000', 'straight', 'line', '.']",[1 2 0 ... 0 0 0],5
203,9,Take-Two Interactive Software (NASDAQ:TTWO) Just fell below 52 week low.,9,0,11,"http://www.google.com/finance?client=ob&amp;q=NASDAQ:TTWO

With poor quarterly earnings, the stock is at its lowest in over a year. Rockstar Games, the publisher of Grand Theft Auto, is one of its subsidiaries. With GTA 5 on the horizon, could this pull the stock back up to its post GTA 4 price?

I'm thinking about going long on TTWO once it stops falling.","['take-two', 'interact', 'softwar', '(', 'nasdaq', ':', 'ttwo', ')', 'just', 'fell', '52', 'week', 'low', '.', 'http', ':', '//www.google.com/fin', '?', 'client=ob', '&', 'amp', ';', 'q=nasdaq', ':', 'ttwo', 'with', 'poor', 'quarterli', 'earn', ',', 'stock', 'lowest', 'year', '.', 'rockstar', 'game', ',', 'publish', 'grand', 'theft', 'auto', ',', 'one', 'subsidiari', '.', 'with', 'gta', '5', 'horizon', ',', 'could', 'pull', 'stock', 'back', 'post', 'gta', '4', 'price', '?', 'i', ""'m"", 'think', 'go', 'long', 'ttwo', 'stop', 'fall', '.']",[4 4 0 ... 0 0 0],10
669,4,Futures Flash Crash As ES Plummets To Limit Down,7,3,2,,"['futur', 'flash', 'crash', 'as', 'es', 'plummet', 'to', 'limit', 'down', 'nan']",[0 0 0 ... 0 0 0],5
93,11,"Staying with the theme of divergences: If houses are being built, don't they need lumber?",13,2,10,,"['stay', 'theme', 'diverg', ':', 'if', 'hous', 'built', ',', ""n't"", 'need', 'lumber', '?', 'nan']",[1 0 0 ... 0 0 0],10
790,3,SHLD rocket ship +20% to $64.68,4,1,1,"That seems a tad overdone dont you think? lol

Big gap from the low $50's, how long until that is tested?","['shld', 'rocket', 'ship', '+20', '%', '$', '64.68', 'that', 'seem', 'tad', 'overdon', 'dont', 'think', '?', 'lol', 'big', 'gap', 'low', '$', '50', ""'s"", ',', 'long', 'test', '?']",[1 0 0 ... 0 0 0],5
68,14,"The S&amp;P just had two consecutive days of more than 1.5% increase.  Over the past 10 years, there had been 24 such occurrence.",14,0,28,"Following such occurrence:

1 day later, market is down 14 out of 24 times(58%), average down is 1.36%, average up is 0.884%

10 day later, market is down 11 out of 24 times(46%), average down is 5.91%, average up is 3.85%

60 day later, market is down 13 out of 24 times(54%), average down is 13.9%, average up is 7.64%

kpmiller asked about random days, edit to add:

Since 2002, there have been 2663 trading days.

1 day change - 1206 down(45%), avg -0.96%; 11 no chg; 1446 up(54%), avg 0.845%

10 day change - 1111 down(42%), avg -2.82%; 3 no chg; 1549 up(58%), avg 2.37%

60 day change - 1018 down(38%), avg -6.97%; 2 no chg; 1643 up(62%), avg 6.3%
","['the', 's', '&', 'amp', ';', 'p', 'two', 'consecut', 'day', '1.5', '%', 'increas', '.', 'over', 'past', '10', 'year', ',', '24', 'occurr', '.', 'follow', 'occurr', ':', '1', 'day', 'later', ',', 'market', '14', '24', 'time', '(', '58', '%', ')', ',', 'averag', '1.36', '%', ',', 'averag', '0.884', '%', '10', 'day', 'later', ',', 'market', '11', '24', 'time', '(', '46', '%', ')', ',', 'averag', '5.91', '%', ',', 'averag', '3.85', '%', '60', 'day', 'later', ',', 'market', '13', '24', 'time', '(', '54', '%', ')', ',', 'averag', '13.9', '%', ',', 'averag', '7.64', '%', 'kpmiller', 'ask', 'random', 'day', ',', 'edit', 'add', ':', 'sinc', '2002', ',', '2663', 'trade', 'day', '.', '1', 'day', 'chang', '-', '1206', '(', '45', '%', ')', ',', 'avg', '-0.96', '%', ';', '11', 'chg', ';', '1446', '(', '54', '%', ')', ',', 'avg', '0.845', '%', '10', 'day', 'chang', '-', '1111', '(', '42', '%', ')', ',', 'avg', '-2.82', '%', ';', '3', 'chg', ';', '1549', '(', '58', '%', ')', ',', 'avg', '2.37', '%', '60', 'day', 'chang', '-', '1018', '(', '38', '%', ')', ',', 'avg', '-6.97', '%', ';', '2', 'chg', ';', '1643', '(', '62', '%', ')', ',', 'avg', '6.3', '%']",[18  3  0 ...  0  0  0],15
881,3,Marc Faber: Apple Has Peaked Out,6,3,11,,"['marc', 'faber', ':', 'appl', 'ha', 'peak', 'out', 'nan']",[0 0 0 ... 0 0 0],5
284,7,New 52wk highs for Monday April 8th,9,2,0,"    EWJ	11.08	48661238	1.09%
    BBY	26.01	27170522	2.20%
    S	6.29	21087117	0.96%
    CX	12.64	12085046	1.77%
    NWSA	31.31	10443577	2.19%
    LUFK	87.91	9768990	37.51%
    DIS	58.49	7277249	1.37%
    IYR	71.26	6371979	0.76%
    DXJ	45.39	6354126	1.98%
    HIMX	5.85	4705477	8.53%","['new', '52wk', 'high', 'monday', 'april', '8th', 'ewj', '11.08', '48661238', '1.09', '%', 'bbi', '26.01', '27170522', '2.20', '%', 's', '6.29', '21087117', '0.96', '%', 'cx', '12.64', '12085046', '1.77', '%', 'nwsa', '31.31', '10443577', '2.19', '%', 'lufk', '87.91', '9768990', '37.51', '%', 'di', '58.49', '7277249', '1.37', '%', 'iyr', '71.26', '6371979', '0.76', '%', 'dxj', '45.39', '6354126', '1.98', '%', 'himx', '5.85', '4705477', '8.53', '%']",[0 0 0 ... 0 0 0],5
799,4,China at risk if Europe gets worse,4,0,1,"I like the use of ""if"" in that sentence.

Europe IS worse, its just a matter of time before this hits China and there magical month over month GDP growth.

--------------

China’s economic expansion would be cut almost in half if Europe’s debt crisis worsens, a scenario that would warrant “significant” fiscal stimulus from the nation’s government, the International Monetary Fund said.

Based on the IMF’s “downside” forecast for the global economy, China’s growth could drop by as much as 4 percentage points from the fund’s current projection, which is for 8.2 percent this year, the organization said in a report released today by its China office in Beijing.

The outlook expands on the IMF’s warning last month that the world could plunge into another recession if Europe’s woes deepen. Premier Wen Jiabao reiterated last week his government will “fine-tune” policies to support growth amid the region’s debt crisis and the cooling domestic property market. 

http://www.bloomberg.com/news/2012-02-06/china-may-see-deeper-economic-slowdown-if-europe-crisis-worsens-imf-says.html","['china', 'risk', 'europ', 'get', 'wors', 'i', 'like', 'use', '``', ""''"", 'sentenc', '.', 'europ', 'is', 'wors', ',', 'matter', 'time', 'hit', 'china', 'magic', 'month', 'month', 'gdp', 'growth', '.', '--', '--', '--', '--', '--', '--', '--', 'china', '’', 'econom', 'expans', 'would', 'cut', 'almost', 'half', 'europ', '’', 'debt', 'crisi', 'worsen', ',', 'scenario', 'would', 'warrant', '“', 'signific', '”', 'fiscal', 'stimulu', 'nation', '’', 'govern', ',', 'intern', 'monetari', 'fund', 'said', '.', 'base', 'imf', '’', '“', 'downsid', '”', 'forecast', 'global', 'economi', ',', 'china', '’', 'growth', 'could', 'drop', 'much', '4', 'percentag', 'point', 'fund', '’', 'current', 'project', ',', '8.2', 'percent', 'year', ',', 'organ', 'said', 'report', 'releas', 'today', 'china', 'offic', 'beij', '.', 'the', 'outlook', 'expand', 'imf', '’', 'warn', 'last', 'month', 'world', 'could', 'plung', 'anoth', 'recess', 'europ', '’', 'woe', 'deepen', '.', 'premier', 'wen', 'jiabao', 'reiter', 'last', 'week', 'govern', '“', 'fine-tun', '”', 'polici', 'support', 'growth', 'amid', 'region', '’', 'debt', 'crisi', 'cool', 'domest', 'properti', 'market', '.', 'http', ':', '//www.bloomberg.com/news/2012-02-06/china-may-see-deeper-economic-slowdown-if-europe-crisis-worsens-imf-says.html']",[6 6 0 ... 0 0 0],5
434,6,Anyone take their profits on Sprint,7,1,6,"I got out this morning with a more dollars in my account than last week. I saw Sprint start to climb, jumped abord and made some money. Anyone else caught this wave?","['anyon', 'take', 'profit', 'sprint', 'i', 'got', 'morn', 'dollar', 'account', 'last', 'week', '.', 'i', 'saw', 'sprint', 'start', 'climb', ',', 'jump', 'abord', 'made', 'money', '.', 'anyon', 'els', 'caught', 'wave', '?']",[1 2 0 ... 0 0 0],5
153,10,Buying FB Jun 30 call @1.30,11,1,16,"Just a small bet here, Im thinking MS needs to save face and show some actual upside on this stock after the disaster of the IPO.

Will they come and rescue it here? Im not sure, but Ill take a little wager they try.

Edit: 
Support levels failing, they are not supporting it today, bailing out at 0.90","['buy', 'fb', 'jun', '30', 'call', '@', '1.30', 'just', 'small', 'bet', ',', 'im', 'think', 'ms', 'need', 'save', 'face', 'show', 'actual', 'upsid', 'stock', 'disast', 'ipo', '.', 'will', 'come', 'rescu', '?', 'im', 'sure', ',', 'ill', 'take', 'littl', 'wager', 'tri', '.', 'edit', ':', 'support', 'level', 'fail', ',', 'support', 'today', ',', 'bail', '0.90']",[4 2 0 ... 0 0 0],10
75,12,"Took full gains on Tuesday at 52wk highs, sold all of my stock. I'm all in cash now, just sitting on the sidelines waiting to get back in thinking...",25,13,5,,"['took', 'full', 'gain', 'tuesday', '52wk', 'high', ',', 'sold', 'stock', '.', 'i', ""'m"", 'cash', ',', 'sit', 'sidelin', 'wait', 'get', 'back', 'think', '...', 'nan']",[2 1 0 ... 0 0 0],10
891,3,"MNST -8%, being investigated by attorney general",3,0,3,,"['mnst', '-8', '%', ',', 'investig', 'attorney', 'gener', 'nan']",[1 0 0 ... 0 0 0],5
446,6,Are the tops in for the year?,7,1,29,,"['are', 'top', 'year', '?', 'nan']",[0 0 0 ... 0 0 0],5
188,9,Another -9% day for ZNGA,10,1,6,"Ok, who is going to be the brave soul that will attempt to find a bottom on this death spiral? lol

http://finviz.com/quote.ashx?t=znga

52W Range	2.09 - 15.91","['anoth', '-9', '%', 'day', 'znga', 'ok', ',', 'go', 'brave', 'soul', 'attempt', 'find', 'bottom', 'death', 'spiral', '?', 'lol', 'http', ':', '//finviz.com/quote.ashx', '?', 't=znga', '52w', 'rang', '2.09', '-', '15.91']",[1 0 0 ... 0 0 0],10
271,8,S&amp;P VWAP chart ,8,0,6,,"['s', '&', 'amp', ';', 'p', 'vwap', 'chart', 'nan']",[0 0 0 ... 0 0 0],10
236,9,Amazon.com Stock Rises To New High After Morgan Stanley Upgrade,13,4,2,,"['amazon.com', 'stock', 'rise', 'to', 'new', 'high', 'after', 'morgan', 'stanley', 'upgrad', 'nan']",[0 0 0 ... 0 0 0],10
487,5,Crude oil: is the party over?,5,0,12,"For those who have been watching the price of crude oil tread ever higher, wishing they got in when the party was just starting, I think it's time to consider joining the party on the short-side.  In fact I took up such a position this morning.

But it's important to criticize one's own conclusions.  So here are my arguments why my trade is *wrong*

1. Oil broke into a new high territory a few days ago and there are no real resistance levels below $110.

2. The US Dollar's strength is starting to wane thanks to the Bernanke's jaw-boning.

3. Gold is making a technical bounce, and when that happens it can pull the other commodities along with it.

Offsetting those facts, here's my bear case:

1. There are two gaps waiting to be filled, one from yesterday and on from last week.  If you believe in that kind of thing, that should return the price of crude down to ~$103 then ~$101.

2. Contrary to popular opinion, the chaos in Egypt really doesn't have doodly-squat to do with oil. Some people were afraid that the Suez canal might be closed, creating supply problems.  What a fantasy; that will never happen in a million years.

3. Caught up in the fever, the market has been ignoring bearish news like [this](http://www.investing.com/news/commodities-news/crude-oil-comes-off-16-month-high-after-bearish-iea-report-250152): [T]he IEA said that oil supplies from countries outside the Organization of the Petroleum Exporting Countries will rise by 1.3 million barrels a day in 2014, an annual growth rate that *""has only been achieved once in the last twenty years.""*

4. The inevitable downturn of the US equities market will no doubt revise 2014 consumption forecasts lower.

So, not sure how this will play out, but for better or worse I'm short crude. I do feel like I'm placing myself in front of a freight train, so wish me luck!

EDIT: formatting

EDIT2 (July 12): Ugh, I made almost 1% yesterday and that's been totally wiped away today, and then some, as crude blows through 106. I still like my trade though; don't want to be shaken out too easily. Waiting to see if there's a retest of the high.

EDIT3 (July 16): Sideways action before the Fed meeting tomorrow.  http://www.troll.me/images2/i-would-be-so-happy/if-crude-could-retest-10430-i-would-be-so-happy.jpg

EDIT4 (July 18): Stopped out today as crude retested its high of 107.44.  May look for a re-entry in the next week or two, but I'll take my lumps.","['crude', 'oil', ':', 'parti', '?', 'for', 'watch', 'price', 'crude', 'oil', 'tread', 'ever', 'higher', ',', 'wish', 'got', 'parti', 'start', ',', 'i', 'think', ""'s"", 'time', 'consid', 'join', 'parti', 'short-sid', '.', 'in', 'fact', 'i', 'took', 'posit', 'morn', '.', 'but', ""'s"", 'import', 'critic', 'one', ""'s"", 'conclus', '.', 'so', 'argument', 'trade', '*', 'wrong', '*', '1', '.', 'oil', 'broke', 'new', 'high', 'territori', 'day', 'ago', 'real', 'resist', 'level', '$', '110', '.', '2', '.', 'the', 'us', 'dollar', ""'s"", 'strength', 'start', 'wane', 'thank', 'bernank', ""'s"", 'jaw-bon', '.', '3', '.', 'gold', 'make', 'technic', 'bounc', ',', 'happen', 'pull', 'commod', 'along', '.', 'offset', 'fact', ',', ""'s"", 'bear', 'case', ':', '1', '.', 'there', 'two', 'gap', 'wait', 'fill', ',', 'one', 'yesterday', 'last', 'week', '.', 'if', 'believ', 'kind', 'thing', ',', 'return', 'price', 'crude', '~', '$', '103', '~', '$', '101', '.', '2', '.', 'contrari', 'popular', 'opinion', ',', 'chao', 'egypt', 'realli', ""n't"", 'doodly-squat', 'oil', '.', 'some', 'peopl', 'afraid', 'suez', 'canal', 'might', 'close', ',', 'creat', 'suppli', 'problem', '.', 'what', 'fantasi', ';', 'never', 'happen', 'million', 'year', '.', '3', '.', 'caught', 'fever', ',', 'market', 'ignor', 'bearish', 'news', 'like', '[', ']', '(', 'http', ':', '//www.investing.com/news/commodities-news/crude-oil-comes-off-16-month-high-after-bearish-iea-report-250152', ')', ':', '[', 't', ']', 'iea', 'said', 'oil', 'suppli', 'countri', 'outsid', 'organ', 'petroleum', 'export', 'countri', 'rise', '1.3', 'million', 'barrel', 'day', '2014', ',', 'annual', 'growth', 'rate', '*', ""''"", 'achiev', 'last', 'twenti', 'year', '.', '``', '*', '4', '.', 'the', 'inevit', 'downturn', 'us', 'equiti', 'market', 'doubt', 'revis', '2014', 'consumpt', 'forecast', 'lower', '.', 'so', ',', 'sure', 'play', ',', 'better', 'wors', 'i', ""'m"", 'short', 'crude', '.', 'i', 'feel', 'like', 'i', ""'m"", 'place', 'front', 'freight', 'train', ',', 'wish', 'luck', '!', 'edit', ':', 'format', 'edit2', '(', 'juli', '12', ')', ':', 'ugh', ',', 'i', 'made', 'almost', '1', '%', 'yesterday', ""'s"", 'total', 'wipe', 'away', 'today', ',', ',', 'crude', 'blow', '106', '.', 'i', 'still', 'like', 'trade', 'though', ';', ""n't"", 'want', 'shaken', 'easili', '.', 'wait', 'see', ""'s"", 'retest', 'high', '.', 'edit3', '(', 'juli', '16', ')', ':', 'sideway', 'action', 'fed', 'meet', 'tomorrow', '.', 'http', ':', '//www.troll.me/images2/i-would-be-so-happy/if-crude-could-retest-10430-i-would-be-so-happy.jpg', 'edit4', '(', 'juli', '18', ')', ':', 'stop', 'today', 'crude', 'retest', 'high', '107.44', '.', 'may', 'look', 're-entri', 'next', 'week', 'two', ',', 'i', ""'ll"", 'take', 'lump', '.']",[17 27  0 ...  0  0  0],5
117,10,"I will be in NYC for the SuperStockJockey Launch on Weds.  Rumor is I may be doing some interviews on BloombergTV, WSJ, and possibly FOXBusiness.  Will keep you updated.",15,5,7,"For those wondering why, I placed in two of the two trading competitions held by SuperStockJockey.  They found my story interesting, and have hinted at possibly interviewing me.","['i', 'nyc', 'superstockjockey', 'launch', 'wed', '.', 'rumor', 'i', 'may', 'interview', 'bloombergtv', ',', 'wsj', ',', 'possibl', 'foxbusi', '.', 'will', 'keep', 'updat', '.', 'for', 'wonder', ',', 'i', 'place', 'two', 'two', 'trade', 'competit', 'held', 'superstockjockey', '.', 'they', 'found', 'stori', 'interest', ',', 'hint', 'possibl', 'interview', '.']",[4 5 0 ... 0 0 0],10
813,2,Are Boeing shares immune to Dreamliner woes?,9,7,7,,"['are', 'boe', 'share', 'immun', 'dreamlin', 'woe', '?', 'nan']",[0 0 0 ... 0 0 0],0
512,4,"Daniel Hannan, Cyprus savers accounts raided by Brussels",7,3,0,,"['daniel', 'hannan', ',', 'cypru', 'saver', 'account', 'raid', 'brussel', 'nan']",[1 0 0 ... 0 0 0],5
950,2,An interesting study on shorting VXX every week,4,2,3,,"['an', 'interest', 'studi', 'short', 'vxx', 'everi', 'week', 'nan']",[0 0 0 ... 0 0 0],0
588,4,The New Abnormal Returns...the trend of the last several years the stock market has fallen along with the drop in inflation expectations,6,2,1,,"['the', 'new', 'abnorm', 'return', '...', 'trend', 'last', 'sever', 'year', 'stock', 'market', 'fallen', 'along', 'drop', 'inflat', 'expect', 'nan']",[0 0 0 ... 0 0 0],5
126,12,I was interviewed on Daytradingradio.com,16,4,4,https://www.youtube.com/watch?feature=player_embedded&amp;v=oKEf-SDA6-k,"['i', 'interview', 'daytradingradio.com', 'http', ':', '//www.youtube.com/watch', '?', 'feature=player_embed', '&', 'amp', ';', 'v=okef-sda6-k']",[0 0 0 ... 0 0 0],10
116,9,"Market Map for the week ending Aug 17. GOOG, CSCO, AAPL and &amp; BAC all very green.",13,4,5,,"['market', 'map', 'week', 'end', 'aug', '17', '.', 'goog', ',', 'csco', ',', 'aapl', '&', 'amp', ';', 'bac', 'green', '.', 'nan']",[2 2 0 ... 0 0 0],10
473,7,JPM Explains Why The US Economy Is About To Hit A Brick Wall ,8,1,0,,"['jpm', 'explain', 'whi', 'the', 'us', 'economi', 'is', 'about', 'to', 'hit', 'a', 'brick', 'wall', 'nan']",[0 0 0 ... 0 0 0],5
689,6,Facebook shares drop after Barron's snub,6,0,9,,"['facebook', 'share', 'drop', 'barron', ""'s"", 'snub', 'nan']",[0 0 0 ... 0 0 0],5
57,14,Addicted to trading: When online investors become gamblers - “We have a fairly efficient stock market and few people are capable of exploiting its inefficiencies. Yet typical problem traders think of themselves as smarter than the average person and park their statistical common sense at the door.”,18,4,9,,"['addict', 'trade', ':', 'when', 'onlin', 'investor', 'becom', 'gambler', '-', '“', 'we', 'fairli', 'effici', 'stock', 'market', 'peopl', 'capabl', 'exploit', 'ineffici', '.', 'yet', 'typic', 'problem', 'trader', 'think', 'smarter', 'averag', 'person', 'park', 'statist', 'common', 'sens', 'door.', '”', 'nan']",[0 1 0 ... 0 0 0],15
670,5,Antioquia Gold Inc. Closes Second Tranche Private Placement,5,0,0,,"['antioquia', 'gold', 'inc', '.', 'close', 'second', 'tranch', 'privat', 'placement', 'nan']",[0 1 0 ... 0 0 0],5
907,3,SPY still within the channel,4,1,1,,"['spi', 'still', 'within', 'channel', 'nan']",[0 0 0 ... 0 0 0],5
369,5,No One Buys Retail Anymore,7,2,2,,"['no', 'one', 'buy', 'retail', 'anymor', 'nan']",[0 0 0 ... 0 0 0],5
268,7,Biggest % gainers May 14th,10,3,2,"We are opening up red across the board, naturally a lot of the inverse ETFs will show up as the biggest gainers:

VTUS	Ventrus Biosciences Inc	12.31	12.34%

KERX	Keryx Biopharmaceuticals	2.11	11.64%

FRAN	Francesca's Holdings Corp	25.65	6.77%

DUST	Direxion Dly Gold Miners 3X BR	66.80	6.52%

UVXY	ProShares Ultra VIX Short-Term	15.79	6.47%

BZQ	Proshares Ultshort MSCI Brazil	 77.49	5.47%

CHK	Chesapeake Energy	15.56	5.06%

SYNC	SYNC	9.70	4.98%

EDZ	Emerging Markets Bear 3x Shs	16.08	4.89%

TVIX	VS 2X VIX Short Term	7.35	4.85%

","['biggest', '%', 'gainer', 'may', '14th', 'we', 'open', 'red', 'across', 'board', ',', 'natur', 'lot', 'invers', 'etf', 'show', 'biggest', 'gainer', ':', 'vtu', 'ventru', 'bioscienc', 'inc', '12.31', '12.34', '%', 'kerx', 'keryx', 'biopharmaceut', '2.11', '11.64', '%', 'fran', 'francesca', ""'s"", 'hold', 'corp', '25.65', '6.77', '%', 'dust', 'direxion', 'dli', 'gold', 'miner', '3x', 'br', '66.80', '6.52', '%', 'uvxi', 'proshar', 'ultra', 'vix', 'short-term', '15.79', '6.47', '%', 'bzq', 'proshar', 'ultshort', 'msci', 'brazil', '77.49', '5.47', '%', 'chk', 'chesapeak', 'energi', '15.56', '5.06', '%', 'sync', 'sync', '9.70', '4.98', '%', 'edz', 'emerg', 'market', 'bear', '3x', 'sh', '16.08', '4.89', '%', 'tvix', 'vs', '2x', 'vix', 'short', 'term', '7.35', '4.85', '%']",[1 0 0 ... 0 0 0],5
46,15,Adjusted S&amp;P Normalized to U.S. Dollar Index (DXY),15,0,5,"For over a year, I've been tracking the S&amp;P inverse correlation to the U.S. Dollar to analyse divergences with a chart of a ""Normalized"" version against its S&amp;P counterpart.
https://docs.google.com/spreadsheet/ccc?key=0AjcECxXNIPcKdGJBV2pCdFdObms5OXBPR3dOb1ZfeVE&amp;usp=sharing
This is an update to that endeavour to see if any patterns take place that can be used as a leading indicator to the stock market.
http://www.hotstockmarket.com/image/id/458833/width/900/height/900/flags/LL
Disclaimer:
Although my belief is that this has merit, I take no responsibility to its validity. I think there is something here, but I am not sure that the weighting (equal in this case for each index) is valid. For example, should I have used a fraction the DYX value with the full value of S&amp;P or vice-versa? There is no way to be sure without some sort of correlation analysis.","['adjust', 's', '&', 'amp', ';', 'p', 'normal', 'u.s.', 'dollar', 'index', '(', 'dxi', ')', 'for', 'year', ',', 'i', ""'ve"", 'track', 's', '&', 'amp', ';', 'p', 'invers', 'correl', 'u.s.', 'dollar', 'analys', 'diverg', 'chart', '``', 'normal', ""''"", 'version', 's', '&', 'amp', ';', 'p', 'counterpart', '.', 'http', ':', '//docs.google.com/spreadsheet/ccc', '?', 'key=0ajcecxxnipckdgjbv2pcdfdobms5oxbpr3dob1zfev', '&', 'amp', ';', 'usp=shar', 'thi', 'updat', 'endeavour', 'see', 'pattern', 'take', 'place', 'use', 'lead', 'indic', 'stock', 'market', '.', 'http', ':', '//www.hotstockmarket.com/image/id/458833/width/900/height/900/flags/l', 'disclaim', ':', 'although', 'belief', 'merit', ',', 'i', 'take', 'respons', 'valid', '.', 'i', 'think', 'someth', ',', 'i', 'sure', 'weight', '(', 'equal', 'case', 'index', ')', 'valid', '.', 'for', 'exampl', ',', 'i', 'use', 'fraction', 'dyx', 'valu', 'full', 'valu', 's', '&', 'amp', ';', 'p', 'vice-versa', '?', 'there', 'way', 'sure', 'without', 'sort', 'correl', 'analysi', '.']",[4 5 0 ... 0 0 0],15
349,7,Part of reason why the stock market is a rigged game...But you can make money...Be nimble via education....,7,0,3,,"['part', 'reason', 'stock', 'market', 'rig', 'game', '...', 'but', 'make', 'money', '...', 'be', 'nimbl', 'via', 'educ', '....', 'nan']",[0 0 0 ... 0 0 0],5
195,9,Stock on Fire: How Apple Trades Into a Product Launch,11,2,3,,"['stock', 'fire', ':', 'how', 'appl', 'trade', 'into', 'product', 'launch', 'nan']",[0 0 0 ... 0 0 0],10
994,3,TSLA +20% this morning,3,0,0,"TSLA took a big hit on Friday on news that key officials left the company. It looks like that sell off was a bit overdone because the stock is getting a big bounce off support levels this morning:

http://finviz.com/quote.ashx?t=tsla","['tsla', '+20', '%', 'morn', 'tsla', 'took', 'big', 'hit', 'friday', 'news', 'key', 'offici', 'left', 'compani', '.', 'it', 'look', 'like', 'sell', 'bit', 'overdon', 'stock', 'get', 'big', 'bounc', 'support', 'level', 'morn', ':', 'http', ':', '//finviz.com/quote.ashx', '?', 't=tsla']",[0 1 0 ... 0 0 1],5
829,3,T3 Morning call: Stick with the trend until it changes,3,0,0,,"['t3', 'morn', 'call', ':', 'stick', 'trend', 'chang', 'nan']",[0 0 0 ... 0 0 0],5
732,3,Scottrade is down?,7,4,6,"I've tried to log in several times this AM, but I keep getting the error:

Unfortunately, we are unable to complete your request at this time. We apologize for any inconvenience this may cause.

Anybody else, or just me?","['scottrad', '?', 'i', ""'ve"", 'tri', 'log', 'sever', 'time', 'am', ',', 'i', 'keep', 'get', 'error', ':', 'unfortun', ',', 'unabl', 'complet', 'request', 'time', '.', 'we', 'apolog', 'inconveni', 'may', 'caus', '.', 'anybodi', 'els', ',', '?']",[3 2 0 ... 0 0 0],5
263,7,AAPL longs bailing after nothing new and fancy announced,8,1,7,,"['aapl', 'long', 'bail', 'noth', 'new', 'fanci', 'announc', 'nan']",[0 0 0 ... 0 0 0],5
443,7,"F -3.5%, ford getting hit AH",8,1,7,"International losses will triple in Q2 due to weaker Europe.

I think we start seeing more and more bad numbers from other companies start to to blame Europe for all their problems.","['f', '-3.5', '%', ',', 'ford', 'get', 'hit', 'ah', 'intern', 'loss', 'tripl', 'q2', 'due', 'weaker', 'europ', '.', 'i', 'think', 'start', 'see', 'bad', 'number', 'compani', 'start', 'blame', 'europ', 'problem', '.']",[1 2 0 ... 0 0 0],5
730,3,My thoughts on IWM 28 June 12,5,2,1,,"['my', 'thought', 'iwm', '28', 'june', '12', 'nan']",[0 0 0 ... 0 0 0],5
304,9,Twinkies shutting down!,14,5,11,,"['twinki', 'shut', '!', 'nan']",[0 0 0 ... 0 0 0],10
341,5,JPM hitting 50% Fib level,8,3,4,,"['jpm', 'hit', '50', '%', 'fib', 'level', 'nan']",[0 0 0 ... 0 0 0],5
961,3,Markets open strong on Bernanke comments,3,0,4,"and those comments were that the Fed needs to keep its accommodative policies in place to support the economic recovery.

Well duh, he has been saying that for 3yrs in every single speech.

","['market', 'open', 'strong', 'bernank', 'comment', 'comment', 'fed', 'need', 'keep', 'accommod', 'polici', 'place', 'support', 'econom', 'recoveri', '.', 'well', 'duh', ',', 'say', '3yr', 'everi', 'singl', 'speech', '.']",[1 2 0 ... 0 0 0],5
149,10,And...........ZNGA.,11,1,7,,"['and', '...........', 'znga', '.', 'nan']",[0 1 0 ... 0 0 0],10
124,13,Anyone here in a prop shop? Looking for career advice...,13,0,7,"Hey guys,


I'm looking for advice on a career move, and was wondering if anyone here had any additional information or experience with my situation. I submit to this subreddit quite frequently, but for some strange reason I find the need for a throwaway account. Below is a background about my situation.


So, all through college I was really interested in the markets. Involved with a bunch of investment clubs, extremely passionate about technical/fundamental analysis, really thought I knew what I wanted to do when I graduated. I ended up getting an internship in IB, and moved full time after I graduated. During that time, my technical skills probably doubled. The broker I was paired with was extremely helpful and resourceful, taught me a lot. A lot of my friends went to prop shops after college, but I was too scared. 20k starting salary while living in New York, while the rest of your salary is in commission scared the hell out of me.


3 months after working full time, I get laid off. This was around 2008-2009. I was pretty upset, but wasn't devastated. I was fresh out of college, pretty young, plus unemployment was sweet. I started looking for other jobs in the finance field, but was told to try different things. A lot of suggestions were to try a smaller company to get the experience. Try a different field, you're young you never know what you might like. Job offers come flying in (surprisingly) and I decided to try something different. I accepted a job at a Financial Analyst position at a Pharma firm. It was awful. Experience was really good, but I missed the markets terribly. I start trading while I work. It started off slow, but then i became pretty active. I decided a couple weeks ago I wanted to get back into the financial markets field and started applying.


So far, I've been on 2 interviews, and have a couple coming up. The ones I am particularly interested in are from prop shops I applied to. I had offers from a bunch of scam prop shops, basically 100% commission positions where you have to pay for their training course. There are a few where I can't find reviews on, Infinium, WTS, and Spot Trading. Does anyone here have any insight on those 3 companies? Can anyone offer any advice on trading desks in general? I'm still actively applying, but I really don't want to waste my time if I know the position isn't right for me.


Thanks in advance.

TL;DR trying to get out of my mindless job","['anyon', 'prop', 'shop', '?', 'look', 'career', 'advic', '...', 'hey', 'guy', ',', 'i', ""'m"", 'look', 'advic', 'career', 'move', ',', 'wonder', 'anyon', 'addit', 'inform', 'experi', 'situat', '.', 'i', 'submit', 'subreddit', 'quit', 'frequent', ',', 'strang', 'reason', 'i', 'find', 'need', 'throwaway', 'account', '.', 'below', 'background', 'situat', '.', 'so', ',', 'colleg', 'i', 'realli', 'interest', 'market', '.', 'involv', 'bunch', 'invest', 'club', ',', 'extrem', 'passion', 'technical/fundament', 'analysi', ',', 'realli', 'thought', 'i', 'knew', 'i', 'want', 'i', 'graduat', '.', 'i', 'end', 'get', 'internship', 'ib', ',', 'move', 'full', 'time', 'i', 'graduat', '.', 'dure', 'time', ',', 'technic', 'skill', 'probabl', 'doubl', '.', 'the', 'broker', 'i', 'pair', 'extrem', 'help', 'resourc', ',', 'taught', 'lot', '.', 'a', 'lot', 'friend', 'went', 'prop', 'shop', 'colleg', ',', 'i', 'scare', '.', '20k', 'start', 'salari', 'live', 'new', 'york', ',', 'rest', 'salari', 'commiss', 'scare', 'hell', '.', '3', 'month', 'work', 'full', 'time', ',', 'i', 'get', 'laid', '.', 'thi', 'around', '2008-2009', '.', 'i', 'pretti', 'upset', ',', ""n't"", 'devast', '.', 'i', 'fresh', 'colleg', ',', 'pretti', 'young', ',', 'plu', 'unemploy', 'sweet', '.', 'i', 'start', 'look', 'job', 'financ', 'field', ',', 'told', 'tri', 'differ', 'thing', '.', 'a', 'lot', 'suggest', 'tri', 'smaller', 'compani', 'get', 'experi', '.', 'tri', 'differ', 'field', ',', ""'re"", 'young', 'never', 'know', 'might', 'like', '.', 'job', 'offer', 'come', 'fli', '(', 'surprisingli', ')', 'i', 'decid', 'tri', 'someth', 'differ', '.', 'i', 'accept', 'job', 'financi', 'analyst', 'posit', 'pharma', 'firm', '.', 'it', 'aw', '.', 'experi', 'realli', 'good', ',', 'i', 'miss', 'market', 'terribl', '.', 'i', 'start', 'trade', 'i', 'work', '.', 'it', 'start', 'slow', ',', 'becam', 'pretti', 'activ', '.', 'i', 'decid', 'coupl', 'week', 'ago', 'i', 'want', 'get', 'back', 'financi', 'market', 'field', 'start', 'appli', '.', 'so', 'far', ',', 'i', ""'ve"", '2', 'interview', ',', 'coupl', 'come', '.', 'the', 'one', 'i', 'particularli', 'interest', 'prop', 'shop', 'i', 'appli', '.', 'i', 'offer', 'bunch', 'scam', 'prop', 'shop', ',', 'basic', '100', '%', 'commiss', 'posit', 'pay', 'train', 'cours', '.', 'there', 'i', 'ca', ""n't"", 'find', 'review', ',', 'infinium', ',', 'wt', ',', 'spot', 'trade', '.', 'doe', 'anyon', 'insight', '3', 'compani', '?', 'can', 'anyon', 'offer', 'advic', 'trade', 'desk', 'gener', '?', 'i', ""'m"", 'still', 'activ', 'appli', ',', 'i', 'realli', ""n't"", 'want', 'wast', 'time', 'i', 'know', 'posit', ""n't"", 'right', '.', 'thank', 'advanc', '.', 'tl', ';', 'dr', 'tri', 'get', 'mindless', 'job']",[26 30  0 ...  0  0  0],15
949,3,JNPR earnings leak? Stock taking off +5%,3,0,0,"Catching a bid, volume kicking in.

http://finviz.com/quote.ashx?t=jnpr","['jnpr', 'earn', 'leak', '?', 'stock', 'take', '+5', '%', 'catch', 'bid', ',', 'volum', 'kick', '.', 'http', ':', '//finviz.com/quote.ashx', '?', 't=jnpr']",[1 1 0 ... 0 0 0],5
50,15,Love this guy! Farage dishes it out again!,15,0,6,,"['love', 'guy', '!', 'farag', 'dish', '!', 'nan']",[0 0 0 ... 0 0 0],15
353,6,Fed speak all done. Mentions significant risks. Go long! :),8,2,26,"    2:15p

    Fed expects to keep accommodative monetary policy
    2:15p

    Fed sees low rates through at least late 2014
    2:15p

    Fed keeps short-term rate target at zero to 0.25%
    2:15p

    Fed maintains Operation Twist program
    2:15p

    Fed to keep reinvesting housing debt into MBS
    2:15p

    Fed still sees 'significant downside risks'

","['fed', 'speak', 'done', '.', 'mention', 'signific', 'risk', '.', 'go', 'long', '!', ':', ')', '2:15p', 'fed', 'expect', 'keep', 'accommod', 'monetari', 'polici', '2:15p', 'fed', 'see', 'low', 'rate', 'least', 'late', '2014', '2:15p', 'fed', 'keep', 'short-term', 'rate', 'target', 'zero', '0.25', '%', '2:15p', 'fed', 'maintain', 'oper', 'twist', 'program', '2:15p', 'fed', 'keep', 'reinvest', 'hous', 'debt', 'mb', '2:15p', 'fed', 'still', 'see', ""'signific"", 'downsid', 'risk', ""'""]",[0 2 0 ... 0 0 0],5
922,3,"Stocks to Watch: Bristol-Myers Squibb, Pfizer, Momenta Pharma",3,0,0,,"['stock', 'watch', ':', 'bristol-my', 'squibb', ',', 'pfizer', ',', 'momenta', 'pharma', 'nan']",[2 0 0 ... 0 0 0],5
142,11,Behind Decision to Close Markets,12,1,1,,"['behind', 'decis', 'close', 'market', 'nan']",[0 0 0 ... 0 0 0],10
470,6,Elloitt Wave counters look for that wave 5 any day now.,6,0,13,,"['elloitt', 'wave', 'counter', 'look', 'wave', '5', 'day', '.', 'nan']",[0 1 0 ... 0 0 0],5
399,6,Gold Correlations Break Down as Prices Slump,9,3,5,,"['gold', 'correl', 'break', 'down', 'price', 'slump', 'nan']",[0 0 0 ... 0 0 0],5
622,6,AAPL earnings tomorrow,6,0,0,"Heads up, AAPL reports tomorrow.

The stock has a habit of getting ahead of itself and selling off on earnings, so be prepared for some downside.","['aapl', 'earn', 'tomorrow', 'head', ',', 'aapl', 'report', 'tomorrow', '.', 'the', 'stock', 'habit', 'get', 'ahead', 'sell', 'earn', ',', 'prepar', 'downsid', '.']",[2 2 0 ... 0 0 0],5
320,6,Morgan Stanley Earnings Plunge 50%,7,1,0,,"['morgan', 'stanley', 'earn', 'plung', '50', '%', 'nan']",[0 0 0 ... 0 0 0],5
19,24,Bill Ackman and Carl Icahn have massive battle live on CNBC. MUST WATCH.,26,2,13,,"['bill', 'ackman', 'carl', 'icahn', 'massiv', 'battl', 'live', 'cnbc', '.', 'must', 'watch', '.', 'nan']",[0 2 0 ... 0 0 0],25
847,3,"IMF World Economic Outlook (WEO) Update -- Gradual Upturn in Global Growth During 2013, January 2013",3,0,0,,"['imf', 'world', 'econom', 'outlook', '(', 'weo', ')', 'updat', '--', 'gradual', 'upturn', 'global', 'growth', 'dure', '2013', ',', 'januari', '2013', 'nan']",[1 0 0 ... 0 0 0],5
786,5,Are we about to break out of our rising wedge on the spy?,5,0,6,"We are now seeing diverging indicators as SPY continues to barely stay inside the wedge.  Is a bearish reversal imminent?

chart:

http://stockcharts.com/h-sc/ui?s=SPY&amp;p=60&amp;b=2&amp;g=0&amp;id=p55879889854&amp;a=259488742

rising wedge explained:

http://stockcharts.com/school/doku.php?id=chart_school:chart_analysis:chart_patterns:rising_wedge","['are', 'break', 'rise', 'wedg', 'spi', '?', 'we', 'see', 'diverg', 'indic', 'spi', 'continu', 'bare', 'stay', 'insid', 'wedg', '.', 'is', 'bearish', 'revers', 'immin', '?', 'chart', ':', 'http', ':', '//stockcharts.com/h-sc/ui', '?', 's=spi', '&', 'amp', ';', 'p=60', '&', 'amp', ';', 'b=2', '&', 'amp', ';', 'g=0', '&', 'amp', ';', 'id=p55879889854', '&', 'amp', ';', 'a=259488742', 'rise', 'wedg', 'explain', ':', 'http', ':', '//stockcharts.com/school/doku.php', '?', 'id=chart_school', ':', 'chart_analysi', ':', 'chart_pattern', ':', 'rising_wedg']",[0 1 0 ... 0 0 0],5
803,4,Chart of 1929 stock market crash vs current market,4,0,1,,"['chart', '1929', 'stock', 'market', 'crash', 'vs', 'current', 'market', 'nan']",[0 0 0 ... 0 0 0],5
407,5,Always Do Your Own Homework « VR View,7,2,0,,"['alway', 'do', 'your', 'own', 'homework', '«', 'vr', 'view', 'nan']",[0 0 0 ... 0 0 0],5
537,5,Asian Markets Gain Ahead of Bank of Japan's Policy Meet - IBTimes UK,6,1,0,,"['asian', 'market', 'gain', 'ahead', 'bank', 'japan', ""'s"", 'polici', 'meet', '-', 'ibtim', 'uk', 'nan']",[0 0 0 ... 0 0 0],5
617,6,NYSE Volume At New Decade Low,6,0,5,,"['nyse', 'volum', 'at', 'new', 'decad', 'low', 'nan']",[0 0 0 ... 0 0 0],5
38,18,"Eric Schmidt to sell 42% of stake in Google - stepped down as CEO in 2011 after 10 years at the helm - Chairman of company will sell 3.2m shares, worth about £1.6bn",19,1,10,,"['eric', 'schmidt', 'sell', '42', '%', 'stake', 'googl', '-', 'step', 'ceo', '2011', '10', 'year', 'helm', '-', 'chairman', 'compani', 'sell', '3.2m', 'share', ',', 'worth', '£1.6bn', 'nan']",[1 0 0 ... 0 0 0],20
175,7,Using Google Trends to help decision-making?,12,5,10,"Just curious as to how many others are trying to ascertain whether Google Trends might be helpful in making market decisions.  I suspect correlations with Twitter are actually higher, but I don't know of a tool to analyze Twitter terms over time, as opposed to trending topics over geographies (sorry for the alliteration there).","['use', 'googl', 'trend', 'help', 'decision-mak', '?', 'just', 'curiou', 'mani', 'other', 'tri', 'ascertain', 'whether', 'googl', 'trend', 'might', 'help', 'make', 'market', 'decis', '.', 'i', 'suspect', 'correl', 'twitter', 'actual', 'higher', ',', 'i', ""n't"", 'know', 'tool', 'analyz', 'twitter', 'term', 'time', ',', 'oppos', 'trend', 'topic', 'geographi', '(', 'sorri', 'alliter', ')', '.']",[2 2 0 ... 0 0 0],5
245,8,Stock Market Analysis &amp; Trade Ideas for 9/23/12,8,0,1,,"['stock', 'market', 'analysi', '&', 'amp', ';', 'trade', 'idea', '9/23/12', 'nan']",[0 0 0 ... 0 0 0],10
823,3,"Global shares drop, dollar slumps as rout gathers pace",4,1,3,,"['global', 'share', 'drop', ',', 'dollar', 'slump', 'rout', 'gather', 'pace', 'nan']",[1 0 0 ... 0 0 0],5
664,3,"Ford, Peugeot, Toyota lead Europe auto sales to new low",4,1,2,,"['ford', ',', 'peugeot', ',', 'toyota', 'lead', 'europ', 'auto', 'sale', 'new', 'low', 'nan']",[2 0 0 ... 0 0 0],5
750,5,ZNGA halted!-13%! LNKD -5%,5,0,15,"Holy cow! Look at the fall out here!

Other social media companies getting whacked, too much bullishness going into the FB ipo.","['znga', 'halt', '!', '-13', '%', '!', 'lnkd', '-5', '%', 'holi', 'cow', '!', 'look', 'fall', '!', 'other', 'social', 'media', 'compani', 'get', 'whack', ',', 'much', 'bullish', 'go', 'fb', 'ipo', '.']",[1 1 0 ... 0 0 0],5
853,2,Mark's Weekly Log; Charts and Analysis,4,2,0,,"['mark', ""'s"", 'weekli', 'log', ';', 'chart', 'analysi', 'nan']",[0 0 0 ... 0 0 0],0
154,11,"Monday Morning, Intresting",12,1,2,"Well, new socialist government in Paris, looking to amend the Euro pact, Greece looking to renegotiate it's bailout terms, George Osboune saying the UK isn't growing as fast as he wants (which he based his debt savings on).

Looking like a interesting opening, some factors probably already factored in, but Neo Nazi's in Greece?  

","['monday', 'morn', ',', 'intrest', 'well', ',', 'new', 'socialist', 'govern', 'pari', ',', 'look', 'amend', 'euro', 'pact', ',', 'greec', 'look', 'renegoti', ""'s"", 'bailout', 'term', ',', 'georg', 'osboun', 'say', 'uk', ""n't"", 'grow', 'fast', 'want', '(', 'base', 'debt', 'save', ')', '.', 'look', 'like', 'interest', 'open', ',', 'factor', 'probabl', 'alreadi', 'factor', ',', 'neo', 'nazi', ""'s"", 'greec', '?']",[7 1 0 ... 0 0 0],10
287,6,Question about DDD,7,1,5,"Today was the day that DDD's three-two split was supposed to happen.  Their stock opened today at 66% of the closing price from last Friday the 22nd.  I have (and have had for the past month) 74 shares in DDD.  This should mean that I should have gotten another 37 shares over the weekend bringing my total up to 111 shares at the beginning of today (monday the 25th).  

When I logged into my tradeking account, however, I still only have 74 shares.  How can this be?  How does the three-two split work?  As of right now I am down over 33% from last friday... (ouch)  

Does it just take time for these gifted stocks to be processed, or am I painfully mistaken on how a three-two split is supposed to work?

http://www.streetinsider.com/Dividends/3D+Systems+(DDD)+Approves+Three-for-Two+Split/8062355.html","['question', 'ddd', 'today', 'day', 'ddd', ""'s"", 'three-two', 'split', 'suppos', 'happen', '.', 'their', 'stock', 'open', 'today', '66', '%', 'close', 'price', 'last', 'friday', '22nd', '.', 'i', '(', 'past', 'month', ')', '74', 'share', 'ddd', '.', 'thi', 'mean', 'i', 'gotten', 'anoth', '37', 'share', 'weekend', 'bring', 'total', '111', 'share', 'begin', 'today', '(', 'monday', '25th', ')', '.', 'when', 'i', 'log', 'tradek', 'account', ',', 'howev', ',', 'i', 'still', '74', 'share', '.', 'how', '?', 'how', 'three-two', 'split', 'work', '?', 'as', 'right', 'i', '33', '%', 'last', 'friday', '...', '(', 'ouch', ')', 'doe', 'take', 'time', 'gift', 'stock', 'process', ',', 'i', 'pain', 'mistaken', 'three-two', 'split', 'suppos', 'work', '?', 'http', ':', '//www.streetinsider.com/dividends/3d+systems+', '(', 'ddd', ')', '+approves+three-for-two+split/8062355.html']",[3 5 0 ... 0 0 0],5
599,6,"Yes, WWE is indeed a public company!",7,1,4,"It showed up in the actives list today, Im not really sure how popular WWE is these days, it feels like the heyday of big names is over and in the past.

MMA is this generations flavor.

WWE rises 10% after earnings and revenue beat expectations.

(AP) -- WWE on Thursday said its first-quarter profit rose 78 percent as the company brought its popular wrestling events to audiences around the globe, including its first performance in the Middle East. 

http://finviz.com/quote.ashx?t=wwe","['ye', ',', 'wwe', 'inde', 'public', 'compani', '!', 'it', 'show', 'activ', 'list', 'today', ',', 'im', 'realli', 'sure', 'popular', 'wwe', 'day', ',', 'feel', 'like', 'heyday', 'big', 'name', 'past', '.', 'mma', 'gener', 'flavor', '.', 'wwe', 'rise', '10', '%', 'earn', 'revenu', 'beat', 'expect', '.', '(', 'ap', ')', '--', 'wwe', 'thursday', 'said', 'first-quart', 'profit', 'rose', '78', 'percent', 'compani', 'brought', 'popular', 'wrestl', 'event', 'audienc', 'around', 'globe', ',', 'includ', 'first', 'perform', 'middl', 'east', '.', 'http', ':', '//finviz.com/quote.ashx', '?', 't=wwe']",[4 4 0 ... 0 0 0],5
569,6,"Stocks to Watch: J.P. Morgan, Lexmark, Green Mountain",6,0,2,,"['stock', 'watch', ':', 'j.p.', 'morgan', ',', 'lexmark', ',', 'green', 'mountain', 'nan']",[2 0 0 ... 0 0 0],5
739,4,More TA for June- S&amp;P and NASDAQ Futures get Weekly support,4,0,4,,"['more', 'ta', 'june-', 's', '&', 'amp', ';', 'p', 'nasdaq', 'futur', 'get', 'weekli', 'support', 'nan']",[0 0 0 ... 0 0 0],5
17,21,July Soybeans market profile and minute chart shows a quick market rotation and a possible support level. [gif],24,3,4,,"['juli', 'soybean', 'market', 'profil', 'minut', 'chart', 'show', 'quick', 'market', 'rotat', 'possibl', 'support', 'level', '.', '[', 'gif', ']', 'nan']",[0 1 0 ... 0 0 0],20
127,11,"NFLX tanking after hours but beat on revenue, EPS, and subscriber growth was within their projected range.",11,0,5,,"['nflx', 'tank', 'hour', 'beat', 'revenu', ',', 'ep', ',', 'subscrib', 'growth', 'within', 'project', 'rang', '.', 'nan']",[2 1 0 ... 0 0 0],10
322,6,Looking at the MMM breakout over 90,7,1,9,,"['look', 'mmm', 'breakout', '90', 'nan']",[0 0 0 ... 0 0 0],5
255,7,"Facebook stock up 3.13%, then down 7.23% after hours??",10,3,14,I'm new to the stock market and for better or worse invested in  Facebook.  I was somewhat excited to see the stock increase by nearly a dollar during trading hours but then it fell over 2 dollars after hours?? As I said I am new to the market but I have never seen that kind of movement after hours on the stock.  How does something like that happen? Thanks,"['facebook', 'stock', '3.13', '%', ',', '7.23', '%', 'hour', '?', '?', 'i', ""'m"", 'new', 'stock', 'market', 'better', 'wors', 'invest', 'facebook', '.', 'i', 'somewhat', 'excit', 'see', 'stock', 'increas', 'nearli', 'dollar', 'trade', 'hour', 'fell', '2', 'dollar', 'hour', '?', '?', 'as', 'i', 'said', 'i', 'new', 'market', 'i', 'never', 'seen', 'kind', 'movement', 'hour', 'stock', '.', 'how', 'someth', 'like', 'happen', '?', 'thank']",[1 2 0 ... 0 0 0],5
807,3,Interactive Global Valuation Heatmaps,5,2,0,,"['interact', 'global', 'valuat', 'heatmap', 'nan']",[0 0 0 ... 0 0 0],5
959,3,VIX related products dominating the actives lists,4,1,1,"Crazy times we live in, you would not have seen this stuff a few years back. Now we get a bit of downside and all these volatile VIX products start soaring!

TVIX	VS 2X VIX Short Term	7.00	19.05%

UVXY	ProShares Ultra VIX Short-Term	14.88	16.71%

VXX	iPath S&amp;P 500 VIX Short-Term	16.99	8.43%

VIIX	VelocityShares VIX Short Term	36.69	8.23%

VIXY	ProShares VIX Short-Term Fut	36.17	8.22%

","['vix', 'relat', 'product', 'domin', 'activ', 'list', 'crazi', 'time', 'live', ',', 'would', 'seen', 'stuff', 'year', 'back', '.', 'now', 'get', 'bit', 'downsid', 'volatil', 'vix', 'product', 'start', 'soar', '!', 'tvix', 'vs', '2x', 'vix', 'short', 'term', '7.00', '19.05', '%', 'uvxi', 'proshar', 'ultra', 'vix', 'short-term', '14.88', '16.71', '%', 'vxx', 'ipath', 's', '&', 'amp', ';', 'p', '500', 'vix', 'short-term', '16.99', '8.43', '%', 'viix', 'velocityshar', 'vix', 'short', 'term', '36.69', '8.23', '%', 'vixi', 'proshar', 'vix', 'short-term', 'fut', '36.17', '8.22', '%']",[1 1 0 ... 0 0 0],5
190,10,Stock Support and Resistance,11,1,1,,"['stock', 'support', 'resist', 'nan']",[0 0 0 ... 0 0 0],10
115,11,Goldman to Clients: Get Out of Stocks Before Fiscal Cliff Hits,15,4,25,,"['goldman', 'client', ':', 'get', 'out', 'stock', 'befor', 'fiscal', 'cliff', 'hit', 'nan']",[0 0 0 ... 0 0 0],10
613,4,GOOG testing support level @600,5,1,1,,"['goog', 'test', 'support', 'level', '@', '600', 'nan']",[0 0 0 ... 0 0 0],5
606,4,Want some REIT exposure: How about AGNC or ROIC?,5,1,2,"I'm not looking for huge dividends or growth specifically, just a good REIT in general.

What are your thoughts on [ROIC](http://finviz.com/quote.ashx?t=roic) and [AGNC](http://finviz.com/quote.ashx?t=agnc&amp;ty=c&amp;ta=1&amp;p=d)?","['want', 'reit', 'exposur', ':', 'how', 'agnc', 'roic', '?', 'i', ""'m"", 'look', 'huge', 'dividend', 'growth', 'specif', ',', 'good', 'reit', 'gener', '.', 'what', 'thought', '[', 'roic', ']', '(', 'http', ':', '//finviz.com/quote.ashx', '?', 't=roic', ')', '[', 'agnc', ']', '(', 'http', ':', '//finviz.com/quote.ashx', '?', 't=agnc', '&', 'amp', ';', 'ty=c', '&', 'amp', ';', 'ta=1', '&', 'amp', ';', 'p=d', ')', '?']",[1 1 0 ... 0 0 0],5
180,9,Why you should still be bullish on stocks | Trading Desk | Investing,11,2,11,,"['whi', 'still', 'bullish', 'stock', '|', 'trade', 'desk', '|', 'invest', 'nan']",[0 0 0 ... 0 0 0],10
301,7,"Dollar Index Pointed Higher, and That Could Be a Problem for Stocks",10,3,0,,"['dollar', 'index', 'point', 'higher', ',', 'that', 'could', 'be', 'problem', 'stock', 'nan']",[1 0 0 ... 0 0 0],5
755,3,Biggest % gainers May 8,4,1,3,"Into the first hour of trading, the following stocks are showing the biggest % gains:

GNRC	Generac Holdings Inc	29.00	25.87%

ARNA	Arena Pharmaceuticals	3.24	19.12%

SVNT	Savient Pharmaceuticals	1.82	16.67%

VSI	Vitamin Shoppe Inc	52.17	16.55%

LOPE	Grand Canyon Education Inc	18.64	16.28%

KGJI	Kingold Jewelry Inc	2.80	14.75%

GTXI	GTx Inc	3.53	13.87%

DUST	Direxion Dly Gold Miners 3X BR	64.53	11.34%

OMX	OfficeMax Incorporated	4.79	8.86%

UVXY	ProShares Ultra VIX Short-Term	15.19	7.96%

","['biggest', '%', 'gainer', 'may', '8', 'into', 'first', 'hour', 'trade', ',', 'follow', 'stock', 'show', 'biggest', '%', 'gain', ':', 'gnrc', 'generac', 'hold', 'inc', '29.00', '25.87', '%', 'arna', 'arena', 'pharmaceut', '3.24', '19.12', '%', 'svnt', 'savient', 'pharmaceut', '1.82', '16.67', '%', 'vsi', 'vitamin', 'shopp', 'inc', '52.17', '16.55', '%', 'lope', 'grand', 'canyon', 'educ', 'inc', '18.64', '16.28', '%', 'kgji', 'kingold', 'jewelri', 'inc', '2.80', '14.75', '%', 'gtxi', 'gtx', 'inc', '3.53', '13.87', '%', 'dust', 'direxion', 'dli', 'gold', 'miner', '3x', 'br', '64.53', '11.34', '%', 'omx', 'officemax', 'incorpor', '4.79', '8.86', '%', 'uvxi', 'proshar', 'ultra', 'vix', 'short-term', '15.19', '7.96', '%']",[1 0 0 ... 0 0 0],5
708,4,Uranium Stocks bottomed?,4,0,8,,"['uranium', 'stock', 'bottom', '?', 'nan']",[0 0 0 ... 0 0 0],5
886,3,Bulls Oust Commodity Bears in Fastest Turnaround Since 2008,3,0,0,,"['bull', 'oust', 'commod', 'bear', 'fastest', 'turnaround', 'sinc', '2008', 'nan']",[0 0 0 ... 0 0 0],5
796,3,"S&amp;P climbs back to 1355, yesterdays highs. Without help from AAPL",4,1,3,"This is very impressive, the S&amp;P has clawed back to yesterdays highs (before AAPL took us down).

Strength in Transports, Utilites, Homebuilders and energy doing the heavy lifting.

Goldminers also strong here, GDX is the ETF.

Dollar index losing the $80 level.

","['s', '&', 'amp', ';', 'p', 'climb', 'back', '1355', ',', 'yesterday', 'high', '.', 'without', 'help', 'aapl', 'thi', 'impress', ',', 's', '&', 'amp', ';', 'p', 'claw', 'back', 'yesterday', 'high', '(', 'aapl', 'took', 'us', ')', '.', 'strength', 'transport', ',', 'utilit', ',', 'homebuild', 'energi', 'heavi', 'lift', '.', 'goldmin', 'also', 'strong', ',', 'gdx', 'etf', '.', 'dollar', 'index', 'lose', '$', '80', 'level', '.']",[5 5 0 ... 0 0 0],5
767,5,Gold starts trading against stocks again.,6,1,5,"Some good graphs: http://www.zerohedge.com/news/stocks-plunge-rare-equity-gold-decoupling

For some reason this was censored in /r/investing...

To me this says, this isn't an inflationary/deflationary event like the end of last year appeared to be, this is a stock crash. Whether it's a ""flash"" crash or not, remains to be seen.

Dead cat bounce from august?

I've been long silver/short sp500 for a few weeks. Obviously a bear.","['gold', 'start', 'trade', 'stock', '.', 'some', 'good', 'graph', ':', 'http', ':', '//www.zerohedge.com/news/stocks-plunge-rare-equity-gold-decoupl', 'for', 'reason', 'censor', '/r/invest', '...', 'to', 'say', ',', ""n't"", 'inflationary/deflationari', 'event', 'like', 'end', 'last', 'year', 'appear', ',', 'stock', 'crash', '.', 'whether', ""'s"", '``', 'flash', ""''"", 'crash', ',', 'remain', 'seen', '.', 'dead', 'cat', 'bounc', 'august', '?', 'i', ""'ve"", 'long', 'silver/short', 'sp500', 'week', '.', 'obvious', 'bear', '.']",[3 5 0 ... 0 0 0],5
517,4,Fed's George warns unwinding balance sheet could disrupt markets,6,2,5,,"['fed', ""'s"", 'georg', 'warn', 'unwind', 'balanc', 'sheet', 'could', 'disrupt', 'market', 'nan']",[0 0 0 ... 0 0 0],5
979,3,IBM soaring to 52wk highs,3,0,4,"Look at that animal go!

http://finviz.com/chart.ashx?t=IBM&amp;ty=c&amp;ta=1&amp;p=d&amp;s=l

Impressive when you see that this was a $100 stock in Apr 2009.

","['ibm', 'soar', '52wk', 'high', 'look', 'anim', 'go', '!', 'http', ':', '//finviz.com/chart.ashx', '?', 't=ibm', '&', 'amp', ';', 'ty=c', '&', 'amp', ';', 'ta=1', '&', 'amp', ';', 'p=d', '&', 'amp', ';', 's=l', 'impress', 'see', '$', '100', 'stock', 'apr', '2009', '.']",[0 1 0 ... 0 0 0],5
45,15,GRPN gets a $9 target,15,0,4,,"['grpn', 'get', '$', '9', 'target', 'nan']",[0 0 0 ... 0 0 0],15
904,3,"HON beats estimates, stock breaks out",4,1,1,,"['hon', 'beat', 'estim', ',', 'stock', 'break', 'nan']",[1 0 0 ... 0 0 0],5
157,10,Textbook Levels Trading: USD/CAD,12,2,14,"[First USD/CAD Trade Entry](http://i.imgur.com/T5zxY.png)

[First USD/CAD Trade Result](http://i.imgur.com/DIDQW.png)

[Second USD/CAD Trade Result](http://i.imgur.com/G6CDR.png)

Sorry, I don't have a ""before"" image for the second trade as I was away from home. The level should be obvious enough.

These patterns occur again and again in the market. You just need to wait for them to occur and then take advantage.","['textbook', 'level', 'trade', ':', 'usd/cad', '[', 'first', 'usd/cad', 'trade', 'entri', ']', '(', 'http', ':', '//i.imgur.com/t5zxy.png', ')', '[', 'first', 'usd/cad', 'trade', 'result', ']', '(', 'http', ':', '//i.imgur.com/didqw.png', ')', '[', 'second', 'usd/cad', 'trade', 'result', ']', '(', 'http', ':', '//i.imgur.com/g6cdr.png', ')', 'sorri', ',', 'i', ""n't"", '``', ""''"", 'imag', 'second', 'trade', 'i', 'away', 'home', '.', 'the', 'level', 'obviou', 'enough', '.', 'these', 'pattern', 'occur', 'market', '.', 'you', 'need', 'wait', 'occur', 'take', 'advantag', '.']",[1 4 0 ... 0 0 0],10
740,4,Biggest % movers June 12th,4,0,0,"After the first 30min of trading, the following stocks are showing the biggest percentage gains:

AONE	A123 Systems Inc	1.19	14.41%

CETV	Central Euro Media Enter'A'	5.46	7.91%

TAM	TAM S.A.	21.90	7.62%

FIO	Fusion-io Inc	18.95	7.61%

KORS	Michael Kors Holdings, Ltd.	41.07	7.57%

ES	Energy Solutions Inc	1.73	6.79%

BRLI	Bio-Reference Labs	23.15	6.63%

ASNA	Ascena Retail Group, Inc.	19.58	6.36%

URI	United Rentals Inc	32.01	6.06%

KITD	KIT digital Inc	3.60	5.26%
","['biggest', '%', 'mover', 'june', '12th', 'after', 'first', '30min', 'trade', ',', 'follow', 'stock', 'show', 'biggest', 'percentag', 'gain', ':', 'aon', 'a123', 'system', 'inc', '1.19', '14.41', '%', 'cetv', 'central', 'euro', 'media', 'enter', ""'"", ""a'"", '5.46', '7.91', '%', 'tam', 'tam', 's.a.', '21.90', '7.62', '%', 'fio', 'fusion-io', 'inc', '18.95', '7.61', '%', 'kor', 'michael', 'kor', 'hold', ',', 'ltd.', '41.07', '7.57', '%', 'es', 'energi', 'solut', 'inc', '1.73', '6.79', '%', 'brli', 'bio-refer', 'lab', '23.15', '6.63', '%', 'asna', 'ascena', 'retail', 'group', ',', 'inc.', '19.58', '6.36', '%', 'uri', 'unit', 'rental', 'inc', '32.01', '6.06', '%', 'kitd', 'kit', 'digit', 'inc', '3.60', '5.26', '%']",[3 0 0 ... 0 0 0],5
171,8,Where do you start to look for new companies to invest in?,11,3,8,"I look here for companies with drugs in the pipeline and see how their results affect their share prices. 
http://www.drugs.com/clinical_trials.html

Anybody have other resources that help steer them to potential good investments?","['where', 'start', 'look', 'new', 'compani', 'invest', '?', 'i', 'look', 'compani', 'drug', 'pipelin', 'see', 'result', 'affect', 'share', 'price', '.', 'http', ':', '//www.drugs.com/clinical_trials.html', 'anybodi', 'resourc', 'help', 'steer', 'potenti', 'good', 'invest', '?']",[0 1 0 ... 0 0 0],10
16,24,Day Trades 4/12/13,30,6,14,"Starting a little late
1.  10:24 in ITMN 9.30
1.  10:25 in NVDA 12.90
1. 10:28 in MTSN 1.58
1. 10:29 out NVDA 12.93 +.03
1. 10:30 in MRVL 10:38
1. out ACAD puts from yesterday even   (THIS IS WHY YOU DONT SLEEP IN WITH OPEN POSTIOTLIONS)

Im actaully closing things out right now and stopping today.   feel like shit.  long, rough night that not even my coffee can fix this morning.   see you guys monday,  with a treat for all of you","['day', 'trade', '4/12/13', 'start', 'littl', 'late', '1', '.', '10:24', 'itmn', '9.30', '1', '.', '10:25', 'nvda', '12.90', '1', '.', '10:28', 'mtsn', '1.58', '1', '.', '10:29', 'nvda', '12.93', '+.03', '1', '.', '10:30', 'mrvl', '10:38', '1.', 'acad', 'put', 'yesterday', 'even', '(', 'thi', 'is', 'whi', 'you', 'dont', 'sleep', 'in', 'with', 'open', 'postiotlion', ')', 'im', 'actaulli', 'close', 'thing', 'right', 'stop', 'today', '.', 'feel', 'like', 'shit', '.', 'long', ',', 'rough', 'night', 'even', 'coffe', 'fix', 'morn', '.', 'see', 'guy', 'monday', ',', 'treat']",[2 8 0 ... 0 0 0],25
511,5,Nigel Farage on the Cyprus issue: You have to be mad to invest in the Eurozone! ,8,3,3,,"['nigel', 'farag', 'cypru', 'issu', ':', 'you', 'mad', 'invest', 'eurozon', '!', 'nan']",[0 0 0 ... 0 0 0],5
48,15,Smith &amp; Wesson nose dive on fears of regulations about to hit,16,1,11,"The terrible tragedy that took place in Newton is still very fresh in our minds, but the politics of it will probably start to hit soon.

Smith &amp; Wesson is getting hit hard as investors jump out of the stock, fearing possible regulation and gun bans.

The irony is that they are also experiencing huge sales as gun lovers load up on weapons that they feel might get banned.

http://finviz.com/quote.ashx?t=swhc","['smith', '&', 'amp', ';', 'wesson', 'nose', 'dive', 'fear', 'regul', 'hit', 'the', 'terribl', 'tragedi', 'took', 'place', 'newton', 'still', 'fresh', 'mind', ',', 'polit', 'probabl', 'start', 'hit', 'soon', '.', 'smith', '&', 'amp', ';', 'wesson', 'get', 'hit', 'hard', 'investor', 'jump', 'stock', ',', 'fear', 'possibl', 'regul', 'gun', 'ban', '.', 'the', 'ironi', 'also', 'experienc', 'huge', 'sale', 'gun', 'lover', 'load', 'weapon', 'feel', 'might', 'get', 'ban', '.', 'http', ':', '//finviz.com/quote.ashx', '?', 't=swhc']",[2 3 0 ... 0 0 0],15
966,3,"Anthera Pharmaceuticals, Inc. (ANTH) tumbles over 40% after the company halted its VISTA-16 clinical study due to a lack efficacy",3,0,4,,"['anthera', 'pharmaceut', ',', 'inc.', '(', 'anth', ')', 'tumbl', '40', '%', 'compani', 'halt', 'vista-16', 'clinic', 'studi', 'due', 'lack', 'efficaci', 'nan']",[1 0 0 ... 0 0 0],5
835,2,"HNRG got some big volume today, possible upside reversal here?",4,2,5,"HNRG traded 10x average volume today, I cant seem to find any news, but volume usually precedes price, so putting it on the watch list.

Last trade $6.57.

http://finviz.com/chart.ashx?t=HNRG&amp;ty=c&amp;ta=1&amp;p=d&amp;s=l

Hallador Energy Company is engaged in underground coal mining in the state of Indiana through Sunrise Coal LLC (a wholly owned subsidiary) serving the electric power generation industry. The Company also owns a 45% equity interest in Savoy Energy, L.P., which is a private oil and gas company with operations in Michigan.","['hnrg', 'got', 'big', 'volum', 'today', ',', 'possibl', 'upsid', 'revers', '?', 'hnrg', 'trade', '10x', 'averag', 'volum', 'today', ',', 'i', 'cant', 'seem', 'find', 'news', ',', 'volum', 'usual', 'preced', 'price', ',', 'put', 'watch', 'list', '.', 'last', 'trade', '$', '6.57', '.', 'http', ':', '//finviz.com/chart.ashx', '?', 't=hnrg', '&', 'amp', ';', 'ty=c', '&', 'amp', ';', 'ta=1', '&', 'amp', ';', 'p=d', '&', 'amp', ';', 's=l', 'hallador', 'energi', 'compani', 'engag', 'underground', 'coal', 'mine', 'state', 'indiana', 'sunris', 'coal', 'llc', '(', 'wholli', 'own', 'subsidiari', ')', 'serv', 'electr', 'power', 'gener', 'industri', '.', 'the', 'compani', 'also', 'own', '45', '%', 'equiti', 'interest', 'savoy', 'energi', ',', 'l.p.', ',', 'privat', 'oil', 'ga', 'compani', 'oper', 'michigan', '.']",[6 4 0 ... 0 0 0],0
515,5,"Stocks to Watch: Groupon, JC Penney, BroadSoft",7,2,0,,"['stock', 'watch', ':', 'groupon', ',', 'jc', 'penney', ',', 'broadsoft', 'nan']",[2 0 0 ... 0 0 0],5
682,5,Mark's Weekly Log; Charts and Analysis.,5,0,3,,"['mark', ""'s"", 'weekli', 'log', ';', 'chart', 'analysi', '.', 'nan']",[0 1 0 ... 0 0 0],5
480,6,SPX 1h Head and Shoulders forming.,11,5,35,,"['spx', '1h', 'head', 'shoulder', 'form', '.', 'nan']",[0 1 0 ... 0 0 0],5
283,7,Apple is the hedge fund king once again,16,9,5,,"['appl', 'hedg', 'fund', 'king', 'nan']",[0 0 0 ... 0 0 0],5
714,4,Can someone give me advice on how to start learning about the Stock Market?,8,4,9,I've recently caught an interest and am trying to figure this out. It seems very complex to me and I was wondering if anyone had any links where I could start learning.,"['can', 'someon', 'give', 'advic', 'start', 'learn', 'stock', 'market', '?', 'i', ""'ve"", 'recent', 'caught', 'interest', 'tri', 'figur', '.', 'it', 'seem', 'complex', 'i', 'wonder', 'anyon', 'link', 'i', 'could', 'start', 'learn', '.']",[0 2 0 ... 0 0 0],5
731,4,"Im long ES (S&amp;P futures) 1308.50, trying to squeeze a few points",4,0,21,"Markets internals not too pretty, but Im going to try for a few points of upside here.

EURUSD is getting a nice bounce, gold and silver moving. Utilities and Consumer Staples still in the red, I need these sectors to come over to the green side to get this market going higher here.","['im', 'long', 'es', '(', 's', '&', 'amp', ';', 'p', 'futur', ')', '1308.50', ',', 'tri', 'squeez', 'point', 'market', 'intern', 'pretti', ',', 'im', 'go', 'tri', 'point', 'upsid', '.', 'eurusd', 'get', 'nice', 'bounc', ',', 'gold', 'silver', 'move', '.', 'util', 'consum', 'stapl', 'still', 'red', ',', 'i', 'need', 'sector', 'come', 'green', 'side', 'get', 'market', 'go', 'higher', '.']",[4 3 0 ... 0 0 0],5
225,9,Mark's Weekly Trading Log (4/1-4/5) Charts and Analysis,10,1,0,,"['mark', ""'s"", 'weekli', 'trade', 'log', '(', '4/1-4/5', ')', 'chart', 'analysi', 'nan']",[0 0 0 ... 0 0 0],10
26,17,"Straightest chart I've ever seen.
",20,3,7,,"['straightest', 'chart', 'i', ""'ve"", 'ever', 'seen', '.', 'nan']",[0 1 0 ... 0 0 0],15
778,3,Head and shoulders formation on SLV,4,1,3,"I think we're about to break the neckline!  It looks like a good entry for a short here is coming up.

http://stockcharts.com/h-sc/ui?s=SLV&amp;p=D&amp;b=5&amp;g=0&amp;id=p56466126299&amp;a=259341146

Silver action this morning:

http://www.kitco.com/charts/livesilver.html","['head', 'shoulder', 'format', 'slv', 'i', 'think', ""'re"", 'break', 'necklin', '!', 'it', 'look', 'like', 'good', 'entri', 'short', 'come', '.', 'http', ':', '//stockcharts.com/h-sc/ui', '?', 's=slv', '&', 'amp', ';', 'p=d', '&', 'amp', ';', 'b=5', '&', 'amp', ';', 'g=0', '&', 'amp', ';', 'id=p56466126299', '&', 'amp', ';', 'a=259341146', 'silver', 'action', 'morn', ':', 'http', ':', '//www.kitco.com/charts/livesilver.html']",[0 1 0 ... 0 0 0],5
437,7,"For your viewing pleasure, transparency of my ""Trade Ideas""  successful pick rate.  I will continue to update these after they succeed or fail.",9,2,29,,"['for', 'view', 'pleasur', ',', 'transpar', '``', 'trade', 'idea', ""''"", 'success', 'pick', 'rate', '.', 'i', 'continu', 'updat', 'succeed', 'fail', '.', 'nan']",[1 2 0 ... 0 0 0],5
946,2,Kiss Your Momma Trade Setup,4,2,1,,"['kiss', 'your', 'momma', 'trade', 'setup', 'nan']",[0 0 0 ... 0 0 0],0
364,7,Mark's Weekly Trading Log (8/5-8/9) Charts Analysis and Video,7,0,0,,"['mark', ""'s"", 'weekli', 'trade', 'log', '(', '8/5-8/9', ')', 'chart', 'analysi', 'video', 'nan']",[0 0 0 ... 0 0 0],5
229,7,Mark's Weekly Trading Log (2/11-2/15) Charts and Analysis,9,2,0,,"['mark', ""'s"", 'weekli', 'trade', 'log', '(', '2/11-2/15', ')', 'chart', 'analysi', 'nan']",[0 0 0 ... 0 0 0],5
37,15,"Sorry bears, S&amp;P 500 hits new all-time closing high",18,3,18,,"['sorri', 'bear', ',', 's', '&', 'amp', ';', 'p', '500', 'hit', 'new', 'all-tim', 'close', 'high', 'nan']",[1 0 0 ... 0 0 0],15
960,3,"LEN +4%, saving the housing sector",3,0,1,"(Reuters) - U.S. homebuilder Lennar Corp (NYS:LEN - News) reported its sharpest rise in orders in three quarters and said it was seeing strong signs of improvement in sales activity.

Miami-based Lennar's new home orders have been increasing for four straight quarters as sentiment towards home purchases in the United States improves.

Low interest rates and home prices, and rising rental rates are prompting Americans to consider owning a home.

""We have seen a noticeable improvement in our sales pace per community"" Lennar's Chief Executive Officer Stuart Miller said in a statement.","['len', '+4', '%', ',', 'save', 'hous', 'sector', '(', 'reuter', ')', '-', 'u.s.', 'homebuild', 'lennar', 'corp', '(', 'ny', ':', 'len', '-', 'new', ')', 'report', 'sharpest', 'rise', 'order', 'three', 'quarter', 'said', 'see', 'strong', 'sign', 'improv', 'sale', 'activ', '.', 'miami-bas', 'lennar', ""'s"", 'new', 'home', 'order', 'increas', 'four', 'straight', 'quarter', 'sentiment', 'toward', 'home', 'purchas', 'unit', 'state', 'improv', '.', 'low', 'interest', 'rate', 'home', 'price', ',', 'rise', 'rental', 'rate', 'prompt', 'american', 'consid', 'own', 'home', '.', '``', 'we', 'seen', 'notic', 'improv', 'sale', 'pace', 'per', 'commun', ""''"", 'lennar', ""'s"", 'chief', 'execut', 'offic', 'stuart', 'miller', 'said', 'statement', '.']",[2 4 0 ... 0 0 0],5
374,7,Mark's Weekly Trading Log (6/24-6/28) Charts Analysis,7,0,0,,"['mark', ""'s"", 'weekli', 'trade', 'log', '(', '6/24-6/28', ')', 'chart', 'analysi', 'nan']",[0 0 0 ... 0 0 0],5
469,6,"Citibank - Sorry, no share buyback for you!",6,0,1,"Stress test says no to shitibank.

C losing its afternoon gains here.

","['citibank', '-', 'sorri', ',', 'share', 'buyback', '!', 'stress', 'test', 'say', 'shitibank', '.', 'c', 'lose', 'afternoon', 'gain', '.']",[1 2 0 ... 0 0 0],5
962,3,LNKD +8% on Goldman upgrade,3,0,6,"Goldman Sachs upgrades LNKD from Neutral to Buy.

GS to English translation: We have a lot of stock we want you to buy from us.","['lnkd', '+8', '%', 'goldman', 'upgrad', 'goldman', 'sach', 'upgrad', 'lnkd', 'neutral', 'buy', '.', 'gs', 'english', 'translat', ':', 'we', 'lot', 'stock', 'want', 'buy', 'us', '.']",[0 2 0 ... 0 0 0],5
845,2,Euro sees biggest on day drop since June. Markets lower on Europe fears. Again.,5,3,4,,"['euro', 'see', 'biggest', 'day', 'drop', 'sinc', 'june', '.', 'market', 'lower', 'europ', 'fear', '.', 'again', '.', 'nan']",[0 3 0 ... 0 0 0],0
988,3,"1330 taken out on the S&amp;P, getting closer to the upper channel Im watching",3,0,8,"From my previous posting here: http://www.reddit.com/r/StockMarket/comments/p68ry/spy_technical_analysis_for_feb_1st_daily_chart/

You can see how we are nearing the blue upper part of the channel.

If you dont know anything about charting (Technical Analysis), these lines are just there for my reference, they do not mean the market has to turn when it hits them, but lots of traders watch these things which can make it a self fulfilling prophecy.

When trading in a channel, you want to be buying close to the bottom of the range and selling near the top. As you can see, we are a lot closer to the top.

Anybody else out there have any opinions they want to share? Feel free to jump in!","['1330', 'taken', 's', '&', 'amp', ';', 'p', ',', 'get', 'closer', 'upper', 'channel', 'im', 'watch', 'from', 'previou', 'post', ':', 'http', ':', '//www.reddit.com/r/stockmarket/comments/p68ry/spy_technical_analysis_for_feb_1st_daily_chart/', 'you', 'see', 'near', 'blue', 'upper', 'part', 'channel', '.', 'if', 'dont', 'know', 'anyth', 'chart', '(', 'technic', 'analysi', ')', ',', 'line', 'refer', ',', 'mean', 'market', 'turn', 'hit', ',', 'lot', 'trader', 'watch', 'thing', 'make', 'self', 'fulfil', 'propheci', '.', 'when', 'trade', 'channel', ',', 'want', 'buy', 'close', 'bottom', 'rang', 'sell', 'near', 'top', '.', 'as', 'see', ',', 'lot', 'closer', 'top', '.', 'anybodi', 'els', 'opinion', 'want', 'share', '?', 'feel', 'free', 'jump', '!']",[6 4 0 ... 0 0 0],5
721,3,Stock market movers July 10,4,1,1,"I never knew Magic Jack was a public company, and a cool ticker symbol to boot!

CWTR(F)	Coldwater Creek	0.76	46.13%

SSH	Sunshine Heart Inc	13.69	41.87%

BMTI	BioMimetic Therapeutics Inc	3.44	22.86%

CALL	magicJack Vocal Tec Ltd	21.36	14.16%

AER	Aercap Holdings NV	12.44	11.59%

SHLM	Schulman (A.)	22.16	9.54%

ASML	ASML Holding N.V. New York	52.63	8.61%

CYMI	Cymer Inc	61.54	8.54%

GEVA	Synageva BioPharma Corp	44.47	7.94%

VRNG	Vringo Inc	3.92	7.40%

","['stock', 'market', 'mover', 'juli', '10', 'i', 'never', 'knew', 'magic', 'jack', 'public', 'compani', ',', 'cool', 'ticker', 'symbol', 'boot', '!', 'cwtr', '(', 'f', ')', 'coldwat', 'creek', '0.76', '46.13', '%', 'ssh', 'sunshin', 'heart', 'inc', '13.69', '41.87', '%', 'bmti', 'biomimet', 'therapeut', 'inc', '3.44', '22.86', '%', 'call', 'magicjack', 'vocal', 'tec', 'ltd', '21.36', '14.16', '%', 'aer', 'aercap', 'hold', 'nv', '12.44', '11.59', '%', 'shlm', 'schulman', '(', 'a', '.', ')', '22.16', '9.54', '%', 'asml', 'asml', 'hold', 'n.v.', 'new', 'york', '52.63', '8.61', '%', 'cymi', 'cymer', 'inc', '61.54', '8.54', '%', 'geva', 'synageva', 'biopharma', 'corp', '44.47', '7.94', '%', 'vrng', 'vringo', 'inc', '3.92', '7.40', '%']",[1 1 0 ... 0 0 0],5
194,9,A Low Volume Bull,10,1,4,,"['a', 'low', 'volum', 'bull', 'nan']",[0 0 0 ... 0 0 0],10
849,3,Finding a modulation transfer function of stock prices by deconvolution,5,2,4,"I'm trying to model n-day stock price distributions, given 1-day price distributions.

It seems to me that one should be able to do that by doing a convolution of the 1-day change distribution with a ""modulation transfer function"".

One should be able to determine the shape of the MTF by deconvolving the n-day distribution against the 1-day distribution.

Has anyone here tried that? 

I once knew how to do that shit. I even published a paper apx. 45 years ago deriving the transfer function of a vascular bed by analyzing what happened to a dye pulse passing through it. But I haven't thought about that stuff since! And I have no idea where the paper is!  :-(

As I remember, it involved dividing Fourier Transforms.

Ring any bells?","['find', 'modul', 'transfer', 'function', 'stock', 'price', 'deconvolut', 'i', ""'m"", 'tri', 'model', 'n-day', 'stock', 'price', 'distribut', ',', 'given', '1-day', 'price', 'distribut', '.', 'it', 'seem', 'one', 'abl', 'convolut', '1-day', 'chang', 'distribut', '``', 'modul', 'transfer', 'function', ""''"", '.', 'one', 'abl', 'determin', 'shape', 'mtf', 'deconvolv', 'n-day', 'distribut', '1-day', 'distribut', '.', 'ha', 'anyon', 'tri', '?', 'i', 'knew', 'shit', '.', 'i', 'even', 'publish', 'paper', 'apx', '.', '45', 'year', 'ago', 'deriv', 'transfer', 'function', 'vascular', 'bed', 'analyz', 'happen', 'dye', 'puls', 'pass', '.', 'but', 'i', ""n't"", 'thought', 'stuff', 'sinc', '!', 'and', 'i', 'idea', 'paper', '!', ':', '-', '(', 'as', 'i', 'rememb', ',', 'involv', 'divid', 'fourier', 'transform', '.', 'ring', 'bell', '?']",[2 7 0 ... 0 0 0],5
859,4,"Wall Street Breakfast: Must-Know News November 19, 2012",5,1,0,,"['wall', 'street', 'breakfast', ':', 'must-know', 'new', 'novemb', '19', ',', '2012', 'nan']",[1 0 0 ... 0 0 0],5
503,4,Mark's Weekly Trading Log (58/6-5/10) Charts and Analysis,6,2,0,,"['mark', ""'s"", 'weekli', 'trade', 'log', '(', '58/6-5/10', ')', 'chart', 'analysi', 'nan']",[0 0 0 ... 0 0 0],5
964,3,"Taking some AAPL Apr 540 puts here around 10.00, stop at 8.00",4,1,11,"I got some AAPL Apr 540 puts here, averaged just above 10.00.

If they hit 8.00 I lock in that loss and go cry in the corner.

Im hoping AAPL cracks below 580 and gets some stops triggered.
","['take', 'aapl', 'apr', '540', 'put', 'around', '10.00', ',', 'stop', '8.00', 'i', 'got', 'aapl', 'apr', '540', 'put', ',', 'averag', '10.00', '.', 'if', 'hit', '8.00', 'i', 'lock', 'loss', 'go', 'cri', 'corner', '.', 'im', 'hope', 'aapl', 'crack', '580', 'get', 'stop', 'trigger', '.']",[2 3 0 ... 0 0 0],5
825,1,European stocks claw back ground as markets steady,9,8,1,,"['european', 'stock', 'claw', 'back', 'ground', 'market', 'steadi', 'nan']",[0 0 0 ... 0 0 0],0
579,4,"SPX Daily Rising Wedge Chart and links to more 
charts A'la Marcos.",6,2,4,,"['spx', 'daili', 'rise', 'wedg', 'chart', 'link', 'chart', ""a'la"", 'marco', '.', 'nan']",[0 1 0 ... 0 0 0],5
963,3,FRO - Shipping stocks breaking out,3,0,5,"Huge break out over the past two sessions on FRO:

http://finviz.com/quote.ashx?t=fro

EXM also making a nice +8% move here","['fro', '-', 'ship', 'stock', 'break', 'huge', 'break', 'past', 'two', 'session', 'fro', ':', 'http', ':', '//finviz.com/quote.ashx', '?', 't=fro', 'exm', 'also', 'make', 'nice', '+8', '%', 'move']",[0 0 0 ... 0 0 0],5
162,9,"Wall Street to fall on Fed uncertainty, Wal-Mart",9,0,2,,"['wall', 'street', 'fall', 'fed', 'uncertainti', ',', 'wal-mart', 'nan']",[1 0 0 ... 0 0 0],10
917,4,"Chart! Adjusted S&amp;P Normalized to the US Dollar 
index (DXY)",5,1,4,"link to chart:
http://cdn.hotstockmarket.com/e/ed/ed090943_spx6mdailygraph2overlay.png

linl to thread:
http://www.hotstockmarket.com/t/179687/countdown-to-blastoff/120#post_2874308

link to spreadsheet:
https://docs.google.com/spreadsheet/ccc?key=0AjcECxXNIPcKdGJBV2pCdFdObms5OXBPR3dOb1ZfeVE

other charts and analysis in my log:
http://www.hotstockmarket.com/t/166656/marks-trading-log/40#post_2873011","['chart', '!', 'adjust', 's', '&', 'amp', ';', 'p', 'normal', 'us', 'dollar', 'index', '(', 'dxi', ')', 'link', 'chart', ':', 'http', ':', '//cdn.hotstockmarket.com/e/ed/ed090943_spx6mdailygraph2overlay.png', 'linl', 'thread', ':', 'http', ':', '//www.hotstockmarket.com/t/179687/countdown-to-blastoff/120', '#', 'post_2874308', 'link', 'spreadsheet', ':', 'http', ':', '//docs.google.com/spreadsheet/ccc', '?', 'key=0ajcecxxnipckdgjbv2pcdfdobms5oxbpr3dob1zfev', 'chart', 'analysi', 'log', ':', 'http', ':', '//www.hotstockmarket.com/t/166656/marks-trading-log/40', '#', 'post_2873011']",[0 0 0 ... 0 0 0],5
152,10,Pro-bailout parties may have enough to rule after Greek polls ,11,1,1,,"['pro-bailout', 'parti', 'may', 'enough', 'rule', 'greek', 'poll', 'nan']",[0 0 0 ... 0 0 0],10
677,5,Mark's Weekly Log; Charts and Analysis.,7,2,2,,"['mark', ""'s"", 'weekli', 'log', ';', 'chart', 'analysi', '.', 'nan']",[0 1 0 ... 0 0 0],5
696,5,Wall Street Week Ahead: Waiting for technical signals,5,0,0,,"['wall', 'street', 'week', 'ahead', ':', 'wait', 'technic', 'signal', 'nan']",[0 0 0 ... 0 0 0],5
751,4,Eccentric Technical Analysis: Three Peaks and a Domed House,5,1,0,,"['eccentr', 'technic', 'analysi', ':', 'three', 'peak', 'dome', 'hous', 'nan']",[0 0 0 ... 0 0 0],5
111,9,Entergy stock takes a hit for Super Bowl blackout,12,3,7,,"['entergi', 'stock', 'take', 'hit', 'super', 'bowl', 'blackout', 'nan']",[0 0 0 ... 0 0 0],10
226,8,Should you invest in Google with the coming announcements of Google Fiber?,9,1,23,,"['should', 'invest', 'googl', 'come', 'announc', 'googl', 'fiber', '?', 'nan']",[0 0 0 ... 0 0 0],10
684,5,S&amp;P downgrades Spain's credit rating ,5,0,0,,"['s', '&', 'amp', ';', 'p', 'downgrad', 'spain', ""'s"", 'credit', 'rate', 'nan']",[0 0 0 ... 0 0 0],5
103,10,MSFT: Trade Update.  Hope some of you made money!,17,7,12,,"['msft', ':', 'trade', 'updat', '.', 'hope', 'made', 'money', '!', 'nan']",[0 1 0 ... 0 0 0],10
421,6,Pregame IBM Earnings From Every Angle,8,2,0,,"['pregam', 'ibm', 'earn', 'from', 'everi', 'angl', 'nan']",[0 0 0 ... 0 0 0],5
419,8,Will Big Blue Bleed Red on Earnings or IBM @ $280 by 2015?,9,1,0,,"['will', 'big', 'blue', 'bleed', 'red', 'earn', 'ibm', '@', '$', '280', '2015', '?', 'nan']",[0 0 0 ... 0 0 0],10
746,5,AAPL support here or go for the gap fill?,6,1,5,,"['aapl', 'support', 'go', 'gap', 'fill', '?', 'nan']",[0 0 0 ... 0 0 0],5
586,5,"CNBC has more than its fair share of meaningless graphics, but this one is especially stupid: it’s a chart of an instrument which ceased to exist three months ago, showing what the yield on that instrument did in the run-up to its default.",6,1,1,,"['cnbc', 'fair', 'share', 'meaningless', 'graphic', ',', 'one', 'especi', 'stupid', ':', '’', 'chart', 'instrument', 'ceas', 'exist', 'three', 'month', 'ago', ',', 'show', 'yield', 'instrument', 'run-up', 'default', '.', 'nan']",[2 1 0 ... 0 0 0],5
927,3,Tips for reading the SPY,4,1,3,Anybody have any tips to reading the SPY minute to minute.  I have been working at a prop firm for about a year now and have been doing relatively well.  I want to step my game up but have really hit a road block when it comes to getting a good SPY read.  Also I am not looking to trade the SPY just get a read on it.  ,"['tip', 'read', 'spi', 'anybodi', 'tip', 'read', 'spi', 'minut', 'minut', '.', 'i', 'work', 'prop', 'firm', 'year', 'rel', 'well', '.', 'i', 'want', 'step', 'game', 'realli', 'hit', 'road', 'block', 'come', 'get', 'good', 'spi', 'read', '.', 'also', 'i', 'look', 'trade', 'spi', 'get', 'read', '.']",[0 4 0 ... 0 0 0],5
119,13,"If Israel attacks Iran, what stocks will you buy to catch profits?",15,2,21,,"['if', 'israel', 'attack', 'iran', ',', 'stock', 'buy', 'catch', 'profit', '?', 'nan']",[1 0 0 ... 0 0 0],15
53,13,r/stockmarket hits 6000 subscribers!,15,2,4,"We hit the next big round number, 6000!

Thank you all for building this subreddit over this past year, its really coming along nicely and I am extremely encouraged with the direction this going!","['r/stockmarket', 'hit', '6000', 'subscrib', '!', 'we', 'hit', 'next', 'big', 'round', 'number', ',', '6000', '!', 'thank', 'build', 'subreddit', 'past', 'year', ',', 'realli', 'come', 'along', 'nice', 'i', 'extrem', 'encourag', 'direct', 'go', '!']",[2 0 0 ... 0 0 0],15
151,10,Stock Market Today: Top 10 movers June 21,12,2,8,"Into the first hour of trading, here are the top 10 percentage movers:

EGLE	Eagle Bulk Shipping Inc	4.20	40.94%

ONXX	Onyx Pharmaceuticals	62.25	39.64%

SUNH	Sun Healthcare Group, Inc.	8.36	36.16%

CHTP	Chelsea Therapeutics Intl Ltd	1.62	23.74%

FSS	Federal Signal	5.70	20.25%

LGND	Ligand Pharmaceuticals, Inc.	15.87	9.07%

UGAZ	VS 3x Long Natural Gas ETN	23.58	8.38%

MNKD	MannKind Corporation	2.16	8.00%

ARNA	Arena Pharmaceuticals	11.33	7.90%

OSIR	Osiris Therapeutics Inc	11.94	7.72%

","['stock', 'market', 'today', ':', 'top', '10', 'mover', 'june', '21', 'into', 'first', 'hour', 'trade', ',', 'top', '10', 'percentag', 'mover', ':', 'egl', 'eagl', 'bulk', 'ship', 'inc', '4.20', '40.94', '%', 'onxx', 'onyx', 'pharmaceut', '62.25', '39.64', '%', 'sunh', 'sun', 'healthcar', 'group', ',', 'inc.', '8.36', '36.16', '%', 'chtp', 'chelsea', 'therapeut', 'intl', 'ltd', '1.62', '23.74', '%', 'fss', 'feder', 'signal', '5.70', '20.25', '%', 'lgnd', 'ligand', 'pharmaceut', ',', 'inc.', '15.87', '9.07', '%', 'ugaz', 'vs', '3x', 'long', 'natur', 'ga', 'etn', '23.58', '8.38', '%', 'mnkd', 'mannkind', 'corpor', '2.16', '8.00', '%', 'arna', 'arena', 'pharmaceut', '11.33', '7.90', '%', 'osir', 'osiri', 'therapeut', 'inc', '11.94', '7.72', '%']",[3 0 0 ... 0 0 0],10
403,7,Wall Street set for rally in wake of fiscal pact,9,2,4,,"['wall', 'street', 'set', 'ralli', 'wake', 'fiscal', 'pact', 'nan']",[0 0 0 ... 0 0 0],5
940,3,Does anyone know any free alternatives to the site SEC Form 4?,3,0,4,"The site allows you to search Form 4 filings on an individual basis rather than by company, except it charges like thirty bucks a month. Anyone know of anything better? ","['doe', 'anyon', 'know', 'free', 'altern', 'site', 'sec', 'form', '4', '?', 'the', 'site', 'allow', 'search', 'form', '4', 'file', 'individu', 'basi', 'rather', 'compani', ',', 'except', 'charg', 'like', 'thirti', 'buck', 'month', '.', 'anyon', 'know', 'anyth', 'better', '?']",[1 1 0 ... 0 0 0],5
207,9,Seasonal Charts - Dow Jones Election Year Cycle,13,4,2,,"['season', 'chart', '-', 'dow', 'jone', 'elect', 'year', 'cycl', 'nan']",[0 0 0 ... 0 0 0],10
658,4,Mark's Weekly Trading Log (5/13-5/17) Charts and Analysis,6,2,0,,"['mark', ""'s"", 'weekli', 'trade', 'log', '(', '5/13-5/17', ')', 'chart', 'analysi', 'nan']",[0 0 0 ... 0 0 0],5
869,3,"Wall Street Breakfast: Must-Know News October 30, 2012",4,1,0,,"['wall', 'street', 'breakfast', ':', 'must-know', 'new', 'octob', '30', ',', '2012', 'nan']",[1 0 0 ... 0 0 0],5
758,4,PZZA +17%! Go Papa Johns!,7,3,1,"I ate their pizza once. It was ok... nothing to write home about.

I guess other people really like it!

Papa John's raises full-year outlook:

http://finviz.com/quote.ashx?t=pzza","['pzza', '+17', '%', '!', 'go', 'papa', 'john', '!', 'i', 'ate', 'pizza', '.', 'it', 'ok', '...', 'noth', 'write', 'home', '.', 'i', 'guess', 'peopl', 'realli', 'like', '!', 'papa', 'john', ""'s"", 'rais', 'full-year', 'outlook', ':', 'http', ':', '//finviz.com/quote.ashx', '?', 't=pzza']",[0 2 0 ... 0 0 0],5
8,28,Paulson’s gold fund loses 65% so far this year. Wow.,35,7,17,,"['paulson', '’', 'gold', 'fund', 'lose', '65', '%', 'far', 'year', '.', 'wow', '.', 'nan']",[0 2 0 ... 0 0 0],30
802,3,Nasdaq chart of 2000 vs 2010... Look similar at all?,4,1,1,,"['nasdaq', 'chart', '2000', 'vs', '2010', '...', 'look', 'similar', '?', 'nan']",[0 0 0 ... 0 0 0],5
36,15,Gold Extends Longest Losing Streak in Four Years as Silver Sinks,17,2,4,,"['gold', 'extend', 'longest', 'lose', 'streak', 'four', 'year', 'silver', 'sink', 'nan']",[0 0 0 ... 0 0 0],15
452,7,Biggest % Movers June 4th,7,0,0,"After the first hour of trading here are the biggest percentage movers:

CBLI	Cleveland Biolabs Inc	2.02	58.82%

MTOX	Medtox Scientific Inc	26.69	35.49%

CRED	Credo Petroleum	14.31	31.77%

GALE	Galena Biopharma Inc	1.47	13.95%

VRNG	Vringo Inc	4.57	11.44%

XNPT	XenoPort Inc	5.98	11.15%

MVIS(F)	Microvision Inc	3.27	9.36%

UGAZ	VS 3x Long Natural Gas ETN	20.65	8.95%

SMBL	Smart Balance Inc	6.61	8.90%

AUXL	Auxilium Pharmaceuticals Inc	20.48	8.65%

","['biggest', '%', 'mover', 'june', '4th', 'after', 'first', 'hour', 'trade', 'biggest', 'percentag', 'mover', ':', 'cbli', 'cleveland', 'biolab', 'inc', '2.02', '58.82', '%', 'mtox', 'medtox', 'scientif', 'inc', '26.69', '35.49', '%', 'cred', 'credo', 'petroleum', '14.31', '31.77', '%', 'gale', 'galena', 'biopharma', 'inc', '1.47', '13.95', '%', 'vrng', 'vringo', 'inc', '4.57', '11.44', '%', 'xnpt', 'xenoport', 'inc', '5.98', '11.15', '%', 'mvi', '(', 'f', ')', 'microvis', 'inc', '3.27', '9.36', '%', 'ugaz', 'vs', '3x', 'long', 'natur', 'ga', 'etn', '20.65', '8.95', '%', 'smbl', 'smart', 'balanc', 'inc', '6.61', '8.90', '%', 'auxl', 'auxilium', 'pharmaceut', 'inc', '20.48', '8.65', '%']",[0 0 0 ... 0 0 0],5
651,4,Gold bounce coming this week? 1400 target anyone?,5,1,8,,"['gold', 'bounc', 'come', 'week', '?', '1400', 'target', 'anyon', '?', 'nan']",[0 0 0 ... 0 0 0],5
253,9,$KCG WARNING,9,0,7,if they decide to file for bankruptcy the stock will be halted and delisted. careful taking it home overnight.,"['$', 'kcg', 'warn', 'decid', 'file', 'bankruptci', 'stock', 'halt', 'delist', '.', 'care', 'take', 'home', 'overnight', '.']",[0 2 0 ... 0 0 0],10
303,7,TA Tuesdays! Get your charts out! Here is an update on the S&amp;P chart I made,8,1,4,"I was calling for a bounce in the last S&amp;P chart:

http://www.reddit.com/r/StockMarket/comments/1377f7/im_going_to_have_to_do_something_horrible_and_be/c71eaks

We got the bounce, had a nice little run, but up here at 1420 with no real news on any deal, I would think the nervousness returns.

What are your thoughts on this?

https://www.tradingview.com/x/vrwzqCfo/

Time for a pullback to support or do we keep going higher and get a Santa rally?
","['ta', 'tuesday', '!', 'get', 'chart', '!', 'here', 'updat', 's', '&', 'amp', ';', 'p', 'chart', 'i', 'made', 'i', 'call', 'bounc', 'last', 's', '&', 'amp', ';', 'p', 'chart', ':', 'http', ':', '//www.reddit.com/r/stockmarket/comments/1377f7/im_going_to_have_to_do_something_horrible_and_be/c71eak', 'we', 'got', 'bounc', ',', 'nice', 'littl', 'run', ',', '1420', 'real', 'news', 'deal', ',', 'i', 'would', 'think', 'nervous', 'return', '.', 'what', 'thought', '?', 'http', ':', '//www.tradingview.com/x/vrwzqcfo/', 'time', 'pullback', 'support', 'keep', 'go', 'higher', 'get', 'santa', 'ralli', '?']",[3 1 0 ... 0 0 0],5
816,3,"DWRE a sell? VIX, is it going to give us a sell signal?",4,1,5,,"['dwre', 'sell', '?', 'vix', ',', 'go', 'give', 'us', 'sell', 'signal', '?', 'nan']",[1 0 0 ... 0 0 0],5
571,6,$DDD Potential Short Breakdown here.  Trade Directionally with this one with confirmation.,6,0,6,,"['$', 'ddd', 'potenti', 'short', 'breakdown', '.', 'trade', 'direct', 'one', 'confirm', '.', 'nan']",[0 2 0 ... 0 0 0],5
623,6,WYNN +5% on good China news,6,0,0,"http://finviz.com/chart.ashx?t=WYNN&amp;ty=c&amp;ta=1&amp;p=d&amp;s=l

Barrons- Gaming stocks often swing on news out of China because U.S. companies have made heavy investments in casinos in Macau. Fourth quarter GDP statistics show that China continues to grow at a strong rate, and Macau casino stats released on Monday also showed continued growth, helping push gaming stocks higher early Tuesday. Chinese GDP rose 8.9%, ahead of expectations for 8.6% growth. Macau gaming revenue rose 4.7% over the third quarter.

Wynn Resorts (WYNN) whose stock fell last week on news that its top shareholder had sued to get the company to reveal more financial information, rose 4.5% early on Tuesday. Las Vegas Sands (LVS) was up 1%, and MGM International (MGM) rose 1.3%.","['wynn', '+5', '%', 'good', 'china', 'news', 'http', ':', '//finviz.com/chart.ashx', '?', 't=wynn', '&', 'amp', ';', 'ty=c', '&', 'amp', ';', 'ta=1', '&', 'amp', ';', 'p=d', '&', 'amp', ';', 's=l', 'barrons-', 'game', 'stock', 'often', 'swing', 'news', 'china', 'u.s.', 'compani', 'made', 'heavi', 'invest', 'casino', 'macau', '.', 'fourth', 'quarter', 'gdp', 'statist', 'show', 'china', 'continu', 'grow', 'strong', 'rate', ',', 'macau', 'casino', 'stat', 'releas', 'monday', 'also', 'show', 'continu', 'growth', ',', 'help', 'push', 'game', 'stock', 'higher', 'earli', 'tuesday', '.', 'chines', 'gdp', 'rose', '8.9', '%', ',', 'ahead', 'expect', '8.6', '%', 'growth', '.', 'macau', 'game', 'revenu', 'rose', '4.7', '%', 'third', 'quarter', '.', 'wynn', 'resort', '(', 'wynn', ')', 'whose', 'stock', 'fell', 'last', 'week', 'news', 'top', 'sharehold', 'su', 'get', 'compani', 'reveal', 'financi', 'inform', ',', 'rose', '4.5', '%', 'earli', 'tuesday', '.', 'la', 'vega', 'sand', '(', 'lv', ')', '1', '%', ',', 'mgm', 'intern', '(', 'mgm', ')', 'rose', '1.3', '%', '.']",[5 6 0 ... 0 0 0],5
705,3,Economic Calendar - Forexpros,5,2,3,,"['econom', 'calendar', '-', 'forexpro', 'nan']",[0 0 0 ... 0 0 0],5
715,4,Thoughts on UTIW,5,1,9,"Stock info here:  http://www.finviz.com/quote.ashx?t=UTIW&amp;ty=c&amp;ta=1&amp;p=d&amp;b=1

Financials look decent, though no huge profit margins here.  TA says, imho, that is ready to bounce back off its support like again.  Any other opinions?","['thought', 'utiw', 'stock', 'info', ':', 'http', ':', '//www.finviz.com/quote.ashx', '?', 't=utiw', '&', 'amp', ';', 'ty=c', '&', 'amp', ';', 'ta=1', '&', 'amp', ';', 'p=d', '&', 'amp', ';', 'b=1', 'financi', 'look', 'decent', ',', 'though', 'huge', 'profit', 'margin', '.', 'ta', 'say', ',', 'imho', ',', 'readi', 'bounc', 'back', 'support', 'like', '.', 'ani', 'opinion', '?']",[3 2 0 ... 0 0 0],5
262,8,Good reads on investment? ,12,4,2,"Hey all, I'm a 20 year old Psychology student and for the first time in my life I'm making some real capital. My parents pay for just about everything I do: apartment, college, food, half of my car, etc. (lucky bitch, I know) That being said, I wanted to get involved in the stock market and in other forms of investment. Both my father and grandfather have been pretty successful in their investments. But what's the fun in going to them for advice? Of course I obviously will a little bit, but I wanted to know if anyone had some books or articles or any types of readings they would recommend for anyone looking to start investing. Thanks in advance guys. ","['good', 'read', 'invest', '?', 'hey', ',', 'i', ""'m"", '20', 'year', 'old', 'psycholog', 'student', 'first', 'time', 'life', 'i', ""'m"", 'make', 'real', 'capit', '.', 'my', 'parent', 'pay', 'everyth', 'i', ':', 'apart', ',', 'colleg', ',', 'food', ',', 'half', 'car', ',', 'etc', '.', '(', 'lucki', 'bitch', ',', 'i', 'know', ')', 'that', 'said', ',', 'i', 'want', 'get', 'involv', 'stock', 'market', 'form', 'invest', '.', 'both', 'father', 'grandfath', 'pretti', 'success', 'invest', '.', 'but', ""'s"", 'fun', 'go', 'advic', '?', 'of', 'cours', 'i', 'obvious', 'littl', 'bit', ',', 'i', 'want', 'know', 'anyon', 'book', 'articl', 'type', 'read', 'would', 'recommend', 'anyon', 'look', 'start', 'invest', '.', 'thank', 'advanc', 'guy', '.']",[8 6 0 ... 0 0 0],10
610,5,Scathing editorial by a Goldman Sachs Employee on the culture of the firm and why he quit.....,8,3,6,,"['scath', 'editori', 'goldman', 'sach', 'employe', 'cultur', 'firm', 'quit', '.....', 'nan']",[0 0 0 ... 0 0 0],5
297,6,Market Exuberance and Bubbles. Just some interesting charts.,10,4,1,,"['market', 'exuber', 'bubbl', '.', 'just', 'interest', 'chart', '.', 'nan']",[0 2 0 ... 0 0 0],5
414,6,"Bigbear's S&amp;P chart, a couple of support levels here",6,0,3,,"['bigbear', ""'s"", 's', '&', 'amp', ';', 'p', 'chart', ',', 'coupl', 'support', 'level', 'nan']",[1 0 0 ... 0 0 0],5
150,10,/r/stockmarket IRC?,13,3,25,I suggested it a while back when CJP was asking for suggestions. Does anyone have any interest? The quality of posts here seem to be higher then the other financial subreddits. I think it would be great for sharing ideas and news. ,"['/r/stockmarket', 'irc', '?', 'i', 'suggest', 'back', 'cjp', 'ask', 'suggest', '.', 'doe', 'anyon', 'interest', '?', 'the', 'qualiti', 'post', 'seem', 'higher', 'financi', 'subreddit', '.', 'i', 'think', 'would', 'great', 'share', 'idea', 'news', '.']",[0 3 0 ... 0 0 0],10
784,3,AAPL -$20 hit here,4,1,18,"AAPL just went from $545 to $526 in a flash, looking for news...

No doubt a lot of stops get hit here, naturally the QQQ got taken down with it.","['aapl', '-', '$', '20', 'hit', 'aapl', 'went', '$', '545', '$', '526', 'flash', ',', 'look', 'news', '...', 'no', 'doubt', 'lot', 'stop', 'get', 'hit', ',', 'natur', 'qqq', 'got', 'taken', '.']",[2 1 0 ... 0 0 0],5
640,3,URRE: Hold or Sell?,4,1,10,"If I sell now I'll profit 254.7%, but I'm not savvy enough to understand why the recent gain occurred and would like some input - hold or sell?","['urr', ':', 'hold', 'sell', '?', 'if', 'i', 'sell', 'i', ""'ll"", 'profit', '254.7', '%', ',', 'i', ""'m"", 'savvi', 'enough', 'understand', 'recent', 'gain', 'occur', 'would', 'like', 'input', '-', 'hold', 'sell', '?']",[1 0 0 ... 0 0 0],5
884,3,Time for a rebound in confidence?,4,1,0,,"['time', 'rebound', 'confid', '?', 'nan']",[0 0 0 ... 0 0 0],5
550,5,"Stocks to Watch: Facebook, FedEx, Guidewire Software",8,3,0,,"['stock', 'watch', ':', 'facebook', ',', 'fedex', ',', 'guidewir', 'softwar', 'nan']",[2 0 0 ... 0 0 0],5
787,4,GS +4% as it takes out the Oct highs,4,0,2,"Important move for GS here as it breaks over the Oct highs, just shy of the $120 level at the moment.

GS is leading the financial sector today, JPM +2%, C 1.9% BAC +1.6%

I find it tough to see a lot more upside here on GS, If I was long here, I would be happy to sell around $125.","['gs', '+4', '%', 'take', 'oct', 'high', 'import', 'move', 'gs', 'break', 'oct', 'high', ',', 'shi', '$', '120', 'level', 'moment', '.', 'gs', 'lead', 'financi', 'sector', 'today', ',', 'jpm', '+2', '%', ',', 'c', '1.9', '%', 'bac', '+1.6', '%', 'i', 'find', 'tough', 'see', 'lot', 'upsid', 'gs', ',', 'if', 'i', 'long', ',', 'i', 'would', 'happi', 'sell', 'around', '$', '125', '.']",[5 2 0 ... 0 0 0],5
488,5,hot stocks for tomorrow? aapl nflx bullish tsla bearish,5,0,5,any sentiments on these stocks?  i've got calls on aapl and nflx...  i fear tsla will settle down... buying puts ,"['hot', 'stock', 'tomorrow', '?', 'aapl', 'nflx', 'bullish', 'tsla', 'bearish', 'sentiment', 'stock', '?', ""'ve"", 'got', 'call', 'aapl', 'nflx', '...', 'fear', 'tsla', 'settl', '...', 'buy', 'put']",[0 0 0 ... 0 0 0],5
147,8,ZNGA up 10% Today.  I love virtual cows.,10,2,5,,"['znga', '10', '%', 'today', '.', 'i', 'love', 'virtual', 'cow', '.', 'nan']",[0 2 0 ... 0 0 0],10
146,12,T &amp; VZ putting some pressure on telecoms today,12,0,6,,"['t', '&', 'amp', ';', 'vz', 'put', 'pressur', 'telecom', 'today', 'nan']",[0 0 0 ... 0 0 0],10
716,4,"Marks Trading Log Updated Weekly Log
(Lots of charts and analysis ala Marco's)",4,0,0,http://www.hotstockmarket.com/t/166656/marks-trading-log/60#post_2877279,"['mark', 'trade', 'log', 'updat', 'weekli', 'log', '(', 'lot', 'chart', 'analysi', 'ala', 'marco', ""'s"", ')', 'http', ':', '//www.hotstockmarket.com/t/166656/marks-trading-log/60', '#', 'post_2877279']",[0 0 0 ... 0 0 0],5
926,3,"Stocks to Watch: TXN, AGU, NILE, UTX",3,0,0,,"['stock', 'watch', ':', 'txn', ',', 'agu', ',', 'nile', ',', 'utx', 'nan']",[3 0 0 ... 0 0 0],5
834,3,Herd scatters again as correlations weaken | Investing,4,1,3,,"['herd', 'scatter', 'correl', 'weaken', '|', 'invest', 'nan']",[0 0 0 ... 0 0 0],5
659,4,Does anyone on here not find SEAS a joke? Who would be buying this?,5,1,2,"Would love to just start a discussion, this seems like such a ""Panic to get out of a burning building"" by Blackstone.  That said, it's not panicking if you are the first one out the door -Margin Call quote.","['doe', 'anyon', 'find', 'sea', 'joke', '?', 'who', 'would', 'buy', '?', 'would', 'love', 'start', 'discuss', ',', 'seem', 'like', '``', 'panic', 'get', 'burn', 'build', ""''"", 'blackston', '.', 'that', 'said', ',', ""'s"", 'panick', 'first', 'one', 'door', '-margin', 'call', 'quot', '.']",[2 2 0 ... 0 0 0],5
348,7,FB buys Instagram for $1B. SFLY getting smacked,7,0,0,"Down 7% here, sellers stepping in.

http://finviz.com/quote.ashx?t=sfly","['fb', 'buy', 'instagram', '$', '1b', '.', 'sfli', 'get', 'smack', 'down', '7', '%', ',', 'seller', 'step', '.', 'http', ':', '//finviz.com/quote.ashx', '?', 't=sfli']",[1 2 0 ... 0 0 0],5
463,6,Here we go! AAPL $1001 target,7,1,13,"Topeka Capital Management has put a new target of $1001 on Apple Inc. (NASDAQ:AAPL) as the firm continues its reign as the world’s most valuable company. Topeka said that the company should meet the price target in the next twelve months. The price target is one of gigantic proportions. The analysis sees the company taking in around $160 billion in revenue this year and having an earnings per share of around $44.61. Apple at $1000+ has been talked about before though those estimates are usually in a longer range, most suggesting a 2015 date.

http://www.valuewalk.com/2012/04/apple-inc-aapl-target-now-1001-says-topeka/","['here', 'go', '!', 'aapl', '$', '1001', 'target', 'topeka', 'capit', 'manag', 'put', 'new', 'target', '$', '1001', 'appl', 'inc.', '(', 'nasdaq', ':', 'aapl', ')', 'firm', 'continu', 'reign', 'world', '’', 'valuabl', 'compani', '.', 'topeka', 'said', 'compani', 'meet', 'price', 'target', 'next', 'twelv', 'month', '.', 'the', 'price', 'target', 'one', 'gigant', 'proport', '.', 'the', 'analysi', 'see', 'compani', 'take', 'around', '$', '160', 'billion', 'revenu', 'year', 'earn', 'per', 'share', 'around', '$', '44.61', '.', 'appl', '$', '1000+', 'talk', 'though', 'estim', 'usual', 'longer', 'rang', ',', 'suggest', '2015', 'date', '.', 'http', ':', '//www.valuewalk.com/2012/04/apple-inc-aapl-target-now-1001-says-topeka/']",[1 5 0 ... 0 0 0],5
325,7,"Weekly Sentiment View:Bad Macro, Bad Europe, Bad Asia, Slow America.",8,1,5,"Expecting some short term pain this week on ES_F and a risk off...

I will not be playing this tactically short due to possible fed intervention, I am planning on entering when the market takes more pain (thinking around the 1260s), probably will sell some TLT, buy some BAC and or NCT. I might be wrong, but lets see where things lead us.

If they announce another euro summit, I will front run it with a long eurusd. (1.23 is quite attractive).

As usual, I am not your investment advisor, fund manager and or broker, take my opinion with several grains of salt.
","['weekli', 'sentiment', 'view', ':', 'bad', 'macro', ',', 'bad', 'europ', ',', 'bad', 'asia', ',', 'slow', 'america', '.', 'expect', 'short', 'term', 'pain', 'week', 'es_f', 'risk', '...', 'i', 'play', 'tactic', 'short', 'due', 'possibl', 'fed', 'intervent', ',', 'i', 'plan', 'enter', 'market', 'take', 'pain', '(', 'think', 'around', '1260', ')', ',', 'probabl', 'sell', 'tlt', ',', 'buy', 'bac', 'nct', '.', 'i', 'might', 'wrong', ',', 'let', 'see', 'thing', 'lead', 'us', '.', 'if', 'announc', 'anoth', 'euro', 'summit', ',', 'i', 'front', 'run', 'long', 'eurusd', '.', '(', '1.23', 'quit', 'attract', ')', '.', 'as', 'usual', ',', 'i', 'invest', 'advisor', ',', 'fund', 'manag', 'broker', ',', 'take', 'opinion', 'sever', 'grain', 'salt', '.']",[11  6  0 ...  0  0  0],5
186,7,MHH: Is this tactic valid?,9,2,10,"I'm not new to investing, but I've not put together a strategy like this before.  What are your thoughts on this idea?

Stock: MHH - Mastech Holdings.  They [just announced](http://finance.yahoo.com/news/mastech-holdings-inc-announces-2-221500346.html) a $2 per share dividend on 12/21 payable to shareholders of record on 12/20.

I've read a little and had a few conversations with friends about how the share price will likely decrease by the amount of the dividend after the dividend is paid.  I don't know how accurate this is.

If I take, say, $10,000 and with half, take a Long position (to be a holder of record to get the dividend) with a stop loss at -5%, I should benefit from the dividend, lessened by the amount of the stop-loss delta.

If I take the other half and short the stock at it's current price, with the expectation that it will drop in-line with the dividend amount, I will gain from that change also, to the point I can select at will, until I pull the trigger (with a stop loss at +5% maybe, just in case).

Example: 

* $5,000 / 6.90 (current price) = 724 shares x $2.00 dividend = $1,448 pre-tax and fees gain.

* 724 shares drop to $6.56 per share, subtracting ~$250 from the gain.  New Gain: ~$1148.

* Short 724 hares @ 6.90; hold until price drops by $1.50 = $1,086 pre-tax and fee gain.

* Total gain on investment = ~$2,284.

Does that sound reasonable and feasible?

Thanks! ","['mhh', ':', 'is', 'tactic', 'valid', '?', 'i', ""'m"", 'new', 'invest', ',', 'i', ""'ve"", 'put', 'togeth', 'strategi', 'like', '.', 'what', 'thought', 'idea', '?', 'stock', ':', 'mhh', '-', 'mastech', 'hold', '.', 'they', '[', 'announc', ']', '(', 'http', ':', '//finance.yahoo.com/news/mastech-holdings-inc-announces-2-221500346.html', ')', '$', '2', 'per', 'share', 'dividend', '12/21', 'payabl', 'sharehold', 'record', '12/20', '.', 'i', ""'ve"", 'read', 'littl', 'convers', 'friend', 'share', 'price', 'like', 'decreas', 'amount', 'dividend', 'dividend', 'paid', '.', 'i', ""n't"", 'know', 'accur', '.', 'if', 'i', 'take', ',', 'say', ',', '$', '10,000', 'half', ',', 'take', 'long', 'posit', '(', 'holder', 'record', 'get', 'dividend', ')', 'stop', 'loss', '-5', '%', ',', 'i', 'benefit', 'dividend', ',', 'lessen', 'amount', 'stop-loss', 'delta', '.', 'if', 'i', 'take', 'half', 'short', 'stock', ""'s"", 'current', 'price', ',', 'expect', 'drop', 'in-lin', 'dividend', 'amount', ',', 'i', 'gain', 'chang', 'also', ',', 'point', 'i', 'select', ',', 'i', 'pull', 'trigger', '(', 'stop', 'loss', '+5', '%', 'mayb', ',', 'case', ')', '.', 'exampl', ':', '*', '$', '5,000', '/', '6.90', '(', 'current', 'price', ')', '=', '724', 'share', 'x', '$', '2.00', 'dividend', '=', '$', '1,448', 'pre-tax', 'fee', 'gain', '.', '*', '724', 'share', 'drop', '$', '6.56', 'per', 'share', ',', 'subtract', '~', '$', '250', 'gain', '.', 'new', 'gain', ':', '~', '$', '1148', '.', '*', 'short', '724', 'hare', '@', '6.90', ';', 'hold', 'price', 'drop', '$', '1.50', '=', '$', '1,086', 'pre-tax', 'fee', 'gain', '.', '*', 'total', 'gain', 'invest', '=', '~', '$', '2,284', '.', 'doe', 'sound', 'reason', 'feasibl', '?', 'thank', '!']",[12 12  0 ...  0  0  0],5
123,10,[Update] So the real money trading contest was actually fruitful.  ,13,3,3,,"['[', 'updat', ']', 'so', 'real', 'money', 'trade', 'contest', 'actual', 'fruit', '.', 'nan']",[0 1 0 ... 0 0 0],10
848,3,Mark's Weekly Log; Charts and Analysis,3,0,1,,"['mark', ""'s"", 'weekli', 'log', ';', 'chart', 'analysi', 'nan']",[0 0 0 ... 0 0 0],5
608,5,FXI vs S&amp;P - China index tracking lower,5,0,3,,"['fxi', 'vs', 's', '&', 'amp', ';', 'p', '-', 'china', 'index', 'track', 'lower', 'nan']",[0 0 0 ... 0 0 0],5
143,10,Components of US Real GDP Since 2007,10,0,0,,"['compon', 'us', 'real', 'gdp', 'sinc', '2007', 'nan']",[0 0 0 ... 0 0 0],10
953,3,AOL +44% Sells $1B worth of patents to MSFT,3,0,3,"http://finviz.com/quote.ashx?t=aol

When is the last time you saw a +44% move in AOL! lol

http://finance.yahoo.com/news/aol-sell-800-patents-microsoft-111633146.html","['aol', '+44', '%', 'sell', '$', '1b', 'worth', 'patent', 'msft', 'http', ':', '//finviz.com/quote.ashx', '?', 't=aol', 'when', 'last', 'time', 'saw', '+44', '%', 'move', 'aol', '!', 'lol', 'http', ':', '//finance.yahoo.com/news/aol-sell-800-patents-microsoft-111633146.html']",[0 0 0 ... 0 0 0],5
197,9,Stock Dilution... Question,9,0,8,"I often see on message boards people stating that they are witnessing dilution. How do i find out when a company is issuing more shares? would it be an sec filing or a PR or is it an assumption a lot of times. 

If it makes a difference i am talking about small cap stocks, sometimes pinks or otc's  ","['stock', 'dilut', '...', 'question', 'i', 'often', 'see', 'messag', 'board', 'peopl', 'state', 'wit', 'dilut', '.', 'how', 'find', 'compani', 'issu', 'share', '?', 'would', 'sec', 'file', 'pr', 'assumpt', 'lot', 'time', '.', 'if', 'make', 'differ', 'talk', 'small', 'cap', 'stock', ',', 'sometim', 'pink', 'otc', ""'s""]",[1 2 0 ... 0 0 0],10
609,5,$INDU - Nice volume spike to start OPEX day,5,0,0,,"['$', 'indu', '-', 'nice', 'volum', 'spike', 'start', 'opex', 'day', 'nan']",[0 0 0 ... 0 0 0],5
279,6,Detroit bankruptcy question.,8,2,7,I don't know a lot about stocks and stuff but am curious to know if and how the Detroit bankruptcy would effect stock prices in the city. Would it be a wise to invest in these?,"['detroit', 'bankruptci', 'question', '.', 'i', ""n't"", 'know', 'lot', 'stock', 'stuff', 'curiou', 'know', 'detroit', 'bankruptci', 'would', 'effect', 'stock', 'price', 'citi', '.', 'would', 'wise', 'invest', '?']",[0 2 0 ... 0 0 0],5
293,7,Hedge funds most bullish since 2004,8,1,0,,"['hedg', 'fund', 'bullish', 'sinc', '2004', 'nan']",[0 0 0 ... 0 0 0],5
400,6,Dell's largest shareholder opposes private deal,7,1,5,,"['dell', ""'s"", 'largest', 'sharehold', 'oppos', 'privat', 'deal', 'nan']",[0 0 0 ... 0 0 0],5
122,9,Retail sales decline in June shows consumers are nervous ,12,3,8,,"['retail', 'sale', 'declin', 'june', 'show', 'consum', 'nervou', 'nan']",[0 0 0 ... 0 0 0],10
183,8,"Maniuplation of Audience Share Price Via Fake Twitter Account
| Reuters",9,1,5,,"['maniupl', 'audienc', 'share', 'price', 'via', 'fake', 'twitter', 'account', '|', 'reuter', 'nan']",[0 0 0 ... 0 0 0],10
202,8,Rising wedge.  Use caution.,13,5,0,,"['rise', 'wedg', '.', 'use', 'caution', '.', 'nan']",[0 2 0 ... 0 0 0],10
438,7,Apple Earnings Play,7,0,13,,"['appl', 'earn', 'play', 'nan']",[0 0 0 ... 0 0 0],5
246,8,"Stocks to Watch: Office Depot, Tesla, U.S. Steel",11,3,0,,"['stock', 'watch', ':', 'offic', 'depot', ',', 'tesla', ',', 'u.s.', 'steel', 'nan']",[2 0 0 ... 0 0 0],10
415,7,MCD hits 52wk lows,9,2,5,"A big drag on the Dow here, MCD losing support levels and hitting a 52wk low.

Interestingly enough, I always look to MCD as an indicator of how bad the economy is.

If people dont have jobs, they buy more cheap food from MCD, so you see MCD rising in bad times.

 Is this correlation broken?

http://finviz.com/chart.ashx?t=MCD&amp;ty=c&amp;ta=1&amp;p=d&amp;s=l","['mcd', 'hit', '52wk', 'low', 'a', 'big', 'drag', 'dow', ',', 'mcd', 'lose', 'support', 'level', 'hit', '52wk', 'low', '.', 'interestingli', 'enough', ',', 'i', 'alway', 'look', 'mcd', 'indic', 'bad', 'economi', '.', 'if', 'peopl', 'dont', 'job', ',', 'buy', 'cheap', 'food', 'mcd', ',', 'see', 'mcd', 'rise', 'bad', 'time', '.', 'is', 'correl', 'broken', '?', 'http', ':', '//finviz.com/chart.ashx', '?', 't=mcd', '&', 'amp', ';', 'ty=c', '&', 'amp', ';', 'ta=1', '&', 'amp', ';', 'p=d', '&', 'amp', ';', 's=l']",[4 3 0 ... 0 0 0],5
854,3,US Equities vs Industrial Production « VR View,5,2,2,,"['us', 'equiti', 'vs', 'industri', 'product', '«', 'vr', 'view', 'nan']",[0 0 0 ... 0 0 0],5
761,4,My EURUSD trade idea,5,1,8,"Watching this resistance level from the two previous peaks, Im short in this 1.32ish level, hoping it sticks below this trend.

If it pops over, I will bail and take the hit.


Trying out linking a chart from some chart site here, lets see if this works
https://www.tradingview.com/x/GMmrm4Cr/","['my', 'eurusd', 'trade', 'idea', 'watch', 'resist', 'level', 'two', 'previou', 'peak', ',', 'im', 'short', '1.32ish', 'level', ',', 'hope', 'stick', 'trend', '.', 'if', 'pop', ',', 'i', 'bail', 'take', 'hit', '.', 'tri', 'link', 'chart', 'chart', 'site', ',', 'let', 'see', 'work', 'http', ':', '//www.tradingview.com/x/gmmrm4cr/']",[4 2 0 ... 0 0 0],5
901,3,$A: On Fire,3,0,5,,"['$', 'a', ':', 'on', 'fire', 'nan']",[0 0 0 ... 0 0 0],5
764,4,Fed speak hitting the markets,4,0,6,"ZeroHedge:

The FOMC statement once again had a little for everyone but critically lacked the all-important- ""we'll print now and to infinity"". Key headlines from the statement, via Bloomberg:

    *FED SAYS ECONOMY `EXPANDING MODERATELY'
    *FED SAYS INFLATION `HAS PICKED UP SOMEWHAT' ON ENERGY
    *FED SAYS GROWTH TO STAY MODERATE, `THEN TO PICK UP GRADUALLY'
    *LACKER DISSENTS FROM FOMC DECISION
    *FED SEES `SIGNIFICANT DOWNSIDE RISKS'
    *FED SEES `EXCEPTIONALLY LOW' RATES AT LEAST THROUGH LATE 2014
","['fed', 'speak', 'hit', 'market', 'zerohedg', ':', 'the', 'fomc', 'statement', 'littl', 'everyon', 'critic', 'lack', 'all-important-', '``', ""'ll"", 'print', 'infin', ""''"", '.', 'key', 'headlin', 'statement', ',', 'via', 'bloomberg', ':', '*', 'fed', 'say', 'economi', '`', 'expand', ""moderately'"", '*', 'fed', 'say', 'inflat', '`', 'ha', 'pick', 'up', 'somewhat', ""'"", 'on', 'energi', '*', 'fed', 'say', 'growth', 'to', 'stay', 'moder', ',', '`', 'then', 'to', 'pick', 'up', ""gradually'"", '*', 'lacker', 'dissent', 'from', 'fomc', 'decis', '*', 'fed', 'see', '`', 'signific', 'downsid', ""risks'"", '*', 'fed', 'see', '`', 'except', 'low', ""'"", 'rate', 'at', 'least', 'through', 'late', '2014']",[2 1 0 ... 0 0 0],5
882,5,Some serious buyers come in for FSLR today.,6,1,6,"Started at about 2:20.  Huge volume.
","['some', 'seriou', 'buyer', 'come', 'fslr', 'today', '.', 'start', '2:20', '.', 'huge', 'volum', '.']",[0 3 0 ... 0 0 0],5
129,12,Ganging up on Ackman?,14,2,9,,"['gang', 'ackman', '?', 'nan']",[0 0 0 ... 0 0 0],10
637,3,Mark's Weekly Trading Log (7/22-7/26) Charts Analysis,6,3,0,,"['mark', ""'s"", 'weekli', 'trade', 'log', '(', '7/22-7/26', ')', 'chart', 'analysi', 'nan']",[0 0 0 ... 0 0 0],5
402,5,Celsion Corp. (CLSN): A Buy Write The Way To Go With Data Pending? | iStockAnalyst.com,6,1,8,"Celsion (CLSN) will be releasing their Phase 3 trial results of ThermoDox for liver cancer by the end of this January. If successful, it would become the primary treatment for liver cancer around the world, which is a billion dollar market. If not, this company will be in deep trouble, considering that this is their primary drug candidate.

What do r/StockMarket/ think?","['celsion', 'corp.', '(', 'clsn', ')', ':', 'a', 'buy', 'write', 'the', 'way', 'to', 'go', 'with', 'data', 'pend', '?', '|', 'istockanalyst.com', 'celsion', '(', 'clsn', ')', 'releas', 'phase', '3', 'trial', 'result', 'thermodox', 'liver', 'cancer', 'end', 'januari', '.', 'if', 'success', ',', 'would', 'becom', 'primari', 'treatment', 'liver', 'cancer', 'around', 'world', ',', 'billion', 'dollar', 'market', '.', 'if', ',', 'compani', 'deep', 'troubl', ',', 'consid', 'primari', 'drug', 'candid', '.', 'what', 'r/stockmarket/', 'think', '?']",[4 3 0 ... 0 0 0],5
780,4,"Anyone use Stochastic Oscillators? If so, how/when do you tweak it for different scenarios to time your trading?",4,0,5,,"['anyon', 'use', 'stochast', 'oscil', '?', 'if', ',', 'how/when', 'tweak', 'differ', 'scenario', 'time', 'trade', '?', 'nan']",[1 0 0 ... 0 0 0],5
826,3,Mark's Weekly Trading Log (5/20-5/24) Charts and Analysis,3,0,0,,"['mark', ""'s"", 'weekli', 'trade', 'log', '(', '5/20-5/24', ')', 'chart', 'analysi', 'nan']",[0 0 0 ... 0 0 0],5
735,4,Anyone else sitting with 100% cash? :),9,5,14,"Still feeling very bearish, not convinced by this rally by the news. Waiting for more short setups :)","['anyon', 'els', 'sit', '100', '%', 'cash', '?', ':', ')', 'still', 'feel', 'bearish', ',', 'convinc', 'ralli', 'news', '.', 'wait', 'short', 'setup', ':', ')']",[1 1 0 ... 0 0 0],5
908,3,AAPL pain (chart inside),4,1,8,"[Charts yay!](http://imgur.com/Ru2b0)

I've been short since $617. Covered around $598 for a nice profit. However, I said if we closed below $600 last night I'd short again. I'm in a  bit of a pickle. Charts indicate we're rolling over. Volume, Action, and broken support is all there. Pre-market we're up ~$2. I'm predicting a slight bounce today, but not enough to rally. Thoughts?

I do plan on investing heavy on longs before earnings. 

edit* $617, not $517. Thanks anuauel.","['aapl', 'pain', '(', 'chart', 'insid', ')', '[', 'chart', 'yay', '!', ']', '(', 'http', ':', '//imgur.com/ru2b0', ')', 'i', ""'ve"", 'short', 'sinc', '$', '617', '.', 'cover', 'around', '$', '598', 'nice', 'profit', '.', 'howev', ',', 'i', 'said', 'close', '$', '600', 'last', 'night', 'i', ""'d"", 'short', '.', 'i', ""'m"", 'bit', 'pickl', '.', 'chart', 'indic', ""'re"", 'roll', '.', 'volum', ',', 'action', ',', 'broken', 'support', '.', 'pre-market', ""'re"", '~', '$', '2', '.', 'i', ""'m"", 'predict', 'slight', 'bounc', 'today', ',', 'enough', 'ralli', '.', 'thought', '?', 'i', 'plan', 'invest', 'heavi', 'long', 'earn', '.', 'edit', '*', '$', '617', ',', '$', '517', '.', 'thank', 'anuauel', '.']",[ 5 11  0 ...  0  0  0],5
219,7,Mark's Weekly Trading Log (6/3-6/7) Charts and Analysis,9,2,0,,"['mark', ""'s"", 'weekli', 'trade', 'log', '(', '6/3-6/7', ')', 'chart', 'analysi', 'nan']",[0 0 0 ... 0 0 0],5
641,4,"Activision Blizzard buys back $8.2b worth of stock from Vivendi, making it publicly owned.",4,0,2,,"['activis', 'blizzard', 'buy', 'back', '$', '8.2b', 'worth', 'stock', 'vivendi', ',', 'make', 'publicli', 'own', '.', 'nan']",[1 1 0 ... 0 0 0],5
910,3,What do you guys think of PNC?,3,0,1,"I'm looking at PNC, but I am new to technical analysis. It looks like an Elliot Wave could be completing soon and we see it drop below $55 at least. Am I doing this right? https://www.tradingview.com/x/FuWbNa3h/","['what', 'guy', 'think', 'pnc', '?', 'i', ""'m"", 'look', 'pnc', ',', 'i', 'new', 'technic', 'analysi', '.', 'it', 'look', 'like', 'elliot', 'wave', 'could', 'complet', 'soon', 'see', 'drop', '$', '55', 'least', '.', 'am', 'i', 'right', '?', 'http', ':', '//www.tradingview.com/x/fuwbna3h/']",[1 2 0 ... 0 0 0],5
808,5,MCD comes in at 1.38 vs 1.40 Expected,7,2,3,"Hmm, what to make of this.

If times are tough, people eat more cheap food like MCD, so is this an indicator that its really good out there?

Or is this just something wrong MCD for the Q?
","['mcd', 'come', '1.38', 'vs', '1.40', 'expect', 'hmm', ',', 'make', '.', 'if', 'time', 'tough', ',', 'peopl', 'eat', 'cheap', 'food', 'like', 'mcd', ',', 'indic', 'realli', 'good', '?', 'or', 'someth', 'wrong', 'mcd', 'q', '?']",[3 1 0 ... 0 0 0],5
801,4,Welcome to r/stockmarket!,4,0,0,"This subreddit has been dead for the longest time, but I hope to breath some life back into it and hopefully make this the front page for the stock market on reddit!

Ideas on which direction this goes, what news items or topics will dominate are yet to be established depending on the community needs.

Your suggestions and comments are welcomed!","['welcom', 'r/stockmarket', '!', 'thi', 'subreddit', 'dead', 'longest', 'time', ',', 'i', 'hope', 'breath', 'life', 'back', 'hope', 'make', 'front', 'page', 'stock', 'market', 'reddit', '!', 'idea', 'direct', 'goe', ',', 'news', 'item', 'topic', 'domin', 'yet', 'establish', 'depend', 'commun', 'need', '.', 'your', 'suggest', 'comment', 'welcom', '!']",[2 1 0 ... 0 0 0],5
914,4,$BAC Wedge: Wait for confirmation here.,5,1,2,,"['$', 'bac', 'wedg', ':', 'wait', 'confirm', '.', 'nan']",[0 1 0 ... 0 0 0],5
624,5,C -6% dragging down the financials,5,0,2,"The financial sector was looking strong going into this session, but C hitting -6% now is putting the pressure on

http://finviz.com/chart.ashx?t=C&amp;ty=c&amp;ta=1&amp;p=d&amp;s=l","['c', '-6', '%', 'drag', 'financi', 'the', 'financi', 'sector', 'look', 'strong', 'go', 'session', ',', 'c', 'hit', '-6', '%', 'put', 'pressur', 'http', ':', '//finviz.com/chart.ashx', '?', 't=c', '&', 'amp', ';', 'ty=c', '&', 'amp', ';', 'ta=1', '&', 'amp', ';', 'p=d', '&', 'amp', ';', 's=l']",[1 0 0 ... 0 0 0],5
833,3,"I just posted this in comments, but I want to make sure my question gets answered. It's about the technical details behind hedging.",5,2,11,"Maybe someone who's well informed on how the market-makers operate can chime in.

But I once heard that when a market-maker gets a order for a put that they can't fill, they sell a call and/or buy the underlying stock (or something similar) to cover the put they wrote. 

What this could mean is that when investors get scared and buy puts to hedge, they could actually be pushing the stock price higher. 

This time around, VIX is lower than ever so it is very cheap to hedge. If the above is true then it would be a while before people get actually complacent, and it freefalls.

Thoughts?
","['i', 'post', 'comment', ',', 'i', 'want', 'make', 'sure', 'question', 'get', 'answer', '.', 'it', ""'s"", 'technic', 'detail', 'behind', 'hedg', '.', 'mayb', 'someon', ""'s"", 'well', 'inform', 'market-mak', 'oper', 'chime', '.', 'but', 'i', 'heard', 'market-mak', 'get', 'order', 'put', 'ca', ""n't"", 'fill', ',', 'sell', 'call', 'and/or', 'buy', 'underli', 'stock', '(', 'someth', 'similar', ')', 'cover', 'put', 'wrote', '.', 'what', 'could', 'mean', 'investor', 'get', 'scare', 'buy', 'put', 'hedg', ',', 'could', 'actual', 'push', 'stock', 'price', 'higher', '.', 'thi', 'time', 'around', ',', 'vix', 'lower', 'ever', 'cheap', 'hedg', '.', 'if', 'true', 'would', 'peopl', 'get', 'actual', 'complac', ',', 'freefal', '.', 'thought', '?']",[5 7 0 ... 0 0 0],5
756,3,Aftermath of the Jobs numbers,5,2,1,,"['aftermath', 'job', 'number', 'nan']",[0 0 0 ... 0 0 0],5
386,5,"MCP +10% after earnings, is this chart ready to turn?",7,2,10,,"['mcp', '+10', '%', 'earn', ',', 'chart', 'readi', 'turn', '?', 'nan']",[1 0 0 ... 0 0 0],5
967,3,"GMCR chart, when TA meets FA",4,1,9,,"['gmcr', 'chart', ',', 'ta', 'meet', 'fa', 'nan']",[1 0 0 ... 0 0 0],5
509,5,NVIV receives Humanitarian Device Exemption from FDA today... Here is original Ted Talk by CEO Frank Reynolds to get an overview of what they are trying to do.,5,0,4,,"['nviv', 'receiv', 'humanitarian', 'devic', 'exempt', 'fda', 'today', '...', 'here', 'origin', 'ted', 'talk', 'ceo', 'frank', 'reynold', 'get', 'overview', 'tri', '.', 'nan']",[0 1 0 ... 0 0 0],5
267,7,"Long S&amp;P futures 1337.75, stop at 1332",8,1,26,Taking ES long with stop near the lows of the session.,"['long', 's', '&', 'amp', ';', 'p', 'futur', '1337.75', ',', 'stop', '1332', 'take', 'es', 'long', 'stop', 'near', 'low', 'session', '.']",[1 1 0 ... 0 0 0],5
814,3,MrTopStep closing print 7/11,5,2,1,,"['mrtopstep', 'close', 'print', '7/11', 'nan']",[0 0 0 ... 0 0 0],5
441,7,Citigroup rallies after earnings top forecasts,9,2,9,,"['citigroup', 'ralli', 'earn', 'top', 'forecast', 'nan']",[0 0 0 ... 0 0 0],5
496,7,LKND: Why LinkedIn is Cashing in for Investors,8,1,4,,"['lknd', ':', 'whi', 'linkedin', 'cash', 'investor', 'nan']",[0 0 0 ... 0 0 0],5
112,11,Had back to back amazing days,18,7,26,"http://i.imgur.com/4ZdCPSL.png

http://i.imgur.com/NG5BkVH.png
","['had', 'back', 'back', 'amaz', 'day', 'http', ':', '//i.imgur.com/4zdcpsl.png', 'http', ':', '//i.imgur.com/ng5bkvh.png']",[0 0 0 ... 0 0 0],10
691,4,ECB’s Draghi Unveils ‘Whatever It Takes’,5,1,0,,"['ecb', '’', 'draghi', 'unveil', '‘', 'whatev', 'it', 'take', '’', 'nan']",[0 0 0 ... 0 0 0],5
232,8,"Several Years back, Great Basin Gold (GBG, now GBGLF) was the first security I bought.  Even after I've moved on, its disheartening to see it trade at 0% of the value I bought it for.  Ow, my nostalgia...",12,4,3,,"['sever', 'year', 'back', ',', 'great', 'basin', 'gold', '(', 'gbg', ',', 'gbglf', ')', 'first', 'secur', 'i', 'bought', '.', 'even', 'i', ""'ve"", 'move', ',', 'dishearten', 'see', 'trade', '0', '%', 'valu', 'i', 'bought', '.', 'ow', ',', 'nostalgia', '...', 'nan']",[4 2 0 ... 0 0 0],10
864,4,"Wall Street Breakfast: Must-Know News November 2, 2012",7,3,0,,"['wall', 'street', 'breakfast', ':', 'must-know', 'new', 'novemb', '2', ',', '2012', 'nan']",[1 0 0 ... 0 0 0],5
607,6,VXX 52wk lows $19.57,6,0,8,,"['vxx', '52wk', 'low', '$', '19.57', 'nan']",[0 0 0 ... 0 0 0],5
671,4,What is the best site for Paper Trading?,4,0,4,"I used to trade on Zoodak and do quite well.  It was real time paper trading, allowed shorts, charged for transactions, had margin calls, etc.  It was pretty realistic, but it shut down.  Any suggestions?","['what', 'best', 'site', 'paper', 'trade', '?', 'i', 'use', 'trade', 'zoodak', 'quit', 'well', '.', 'it', 'real', 'time', 'paper', 'trade', ',', 'allow', 'short', ',', 'charg', 'transact', ',', 'margin', 'call', ',', 'etc', '.', 'it', 'pretti', 'realist', ',', 'shut', '.', 'ani', 'suggest', '?']",[5 3 0 ... 0 0 0],5
373,5,10 stocks making new 6wk highs today,8,3,4,"    Symbol	Last	Chg(%)		Industry
    HPQ	26.26	3.1		Computer - Mini
    CSCO	25.31	0.6		Computer - Networks
    FB	25.6	0.47		Internet - Services
    USO	37.25	1.31		Finance - Investment Funds
    NUS	72.03	8.2		Cosmetics And Toiletries
    MDRX	14.24	6.43		Medical Information Systems
    FITB	18.84	0.21		Banks - Major Regional
    FDO	66.14	3.42		Retail - Discount
    HLF	49.8	1.84		Retail - Drug Stores
    JNJ	88.99	0.12		Large Cap Pharma
","['10', 'stock', 'make', 'new', '6wk', 'high', 'today', 'symbol', 'last', 'chg', '(', '%', ')', 'industri', 'hpq', '26.26', '3.1', 'comput', '-', 'mini', 'csco', '25.31', '0.6', 'comput', '-', 'network', 'fb', '25.6', '0.47', 'internet', '-', 'servic', 'uso', '37.25', '1.31', 'financ', '-', 'invest', 'fund', 'nu', '72.03', '8.2', 'cosmet', 'and', 'toiletri', 'mdrx', '14.24', '6.43', 'medic', 'inform', 'system', 'fitb', '18.84', '0.21', 'bank', '-', 'major', 'region', 'fdo', '66.14', '3.42', 'retail', '-', 'discount', 'hlf', '49.8', '1.84', 'retail', '-', 'drug', 'store', 'jnj', '88.99', '0.12', 'larg', 'cap', 'pharma']",[0 0 0 ... 0 0 0],5
976,3,How most people view the stock market and how politicians view it.,3,0,1,,"['how', 'peopl', 'view', 'stock', 'market', 'politician', 'view', '.', 'nan']",[0 1 0 ... 0 0 0],5
837,3,Stock Prediction: What is the accuracy level cut-off?,9,6,5,"For those of you who develop different stock predictors, using whatever method(s), what is the cut-off point where you say, ""This works""? Is it similar to statistics with the 95% / 98% / 99% confidence levels?

tl;dr How much do market analysts scrutinize between 95% and 99% accuracy in stock prediction?","['stock', 'predict', ':', 'what', 'accuraci', 'level', 'cut-off', '?', 'for', 'develop', 'differ', 'stock', 'predictor', ',', 'use', 'whatev', 'method', '(', ')', ',', 'cut-off', 'point', 'say', ',', '``', 'thi', 'work', ""''"", '?', 'is', 'similar', 'statist', '95', '%', '/', '98', '%', '/', '99', '%', 'confid', 'level', '?', 'tl', ';', 'dr', 'how', 'much', 'market', 'analyst', 'scrutin', '95', '%', '99', '%', 'accuraci', 'stock', 'predict', '?']",[3 0 0 ... 0 0 0],5
233,7,"Article: DJIA returns 0% since 1964 (after taxes, fees and inflation)",18,11,14,,"['articl', ':', 'djia', 'return', '0', '%', 'sinc', '1964', '(', 'tax', ',', 'fee', 'inflat', ')', 'nan']",[1 0 0 ... 0 0 0],5
781,6,"SBUX - Up 3.3% AH on release of Verismo, a Keurig-esque single-cup brewer",6,0,3,"http://www.marketwatch.com/story/starbucks-unveils-single-cup-coffee-brewer-2012-03-08?dist=afterbell

Schultz spoke highly of GMCR on the call, but I think everyone sees the writing on the wall: this is bad news for Green Mountain. It looks like the device will focus on ""high-pressure espresso-based beverages"", but offer coffee as well.

I went long at $50.37 today. Hopefully macro issues vis-a-vis Greece/jobs report don't screw me out of a nice gain.","['sbux', '-', 'up', '3.3', '%', 'ah', 'releas', 'verismo', ',', 'keurig-esqu', 'single-cup', 'brewer', 'http', ':', '//www.marketwatch.com/story/starbucks-unveils-single-cup-coffee-brewer-2012-03-08', '?', 'dist=afterbel', 'schultz', 'spoke', 'highli', 'gmcr', 'call', ',', 'i', 'think', 'everyon', 'see', 'write', 'wall', ':', 'bad', 'news', 'green', 'mountain', '.', 'it', 'look', 'like', 'devic', 'focu', '``', 'high-pressur', 'espresso-bas', 'beverag', ""''"", ',', 'offer', 'coffe', 'well', '.', 'i', 'went', 'long', '$', '50.37', 'today', '.', 'hope', 'macro', 'issu', 'vis-a-vi', 'greece/job', 'report', ""n't"", 'screw', 'nice', 'gain', '.']",[3 4 0 ... 0 0 0],5
676,3,"Can we have a vote on whether to ban this crap being posted here over and over again?  It's really, really tedious.",6,3,2,,"['can', 'vote', 'whether', 'ban', 'crap', 'post', '?', 'it', ""'s"", 'realli', ',', 'realli', 'tediou', '.', 'nan']",[1 1 0 ... 0 0 0],5
317,6,"A few of us have been posting various trade ideas, just curious, have any of you traded the ideas and made any money?",8,2,11,,"['a', 'us', 'post', 'variou', 'trade', 'idea', ',', 'curiou', ',', 'trade', 'idea', 'made', 'money', '?', 'nan']",[2 0 0 ... 0 0 0],5
648,5,Are Analysts Worth a Hill of (Jelly)beans?,7,2,0,,"['are', 'analyst', 'worth', 'hill', '(', 'jelli', ')', 'bean', '?', 'nan']",[0 0 0 ... 0 0 0],5
410,7,HPQ getting slammed today -11%,8,1,0,"HP alleges Autonomy wrongdoing, takes $8.8 billion charge


http://www.reuters.com/article/2012/11/20/us-hp-results-idUSBRE8AJ0OB20121120



INFLATED SALES, REVENUE

HP alleged that Autonomy's former management inflated revenue and gross margins to mislead potential buyers. It said Autonomy executives mischaracterized revenue from low-end hardware sales as software sales and booked some licensing deals with partners as revenue, even though no customer bought products.


http://finviz.com/quote.ashx?t=hpq","['hpq', 'get', 'slam', 'today', '-11', '%', 'hp', 'alleg', 'autonomi', 'wrongdo', ',', 'take', '$', '8.8', 'billion', 'charg', 'http', ':', '//www.reuters.com/article/2012/11/20/us-hp-results-idusbre8aj0ob20121120', 'inflat', 'sale', ',', 'revenu', 'hp', 'alleg', 'autonomi', ""'s"", 'former', 'manag', 'inflat', 'revenu', 'gross', 'margin', 'mislead', 'potenti', 'buyer', '.', 'it', 'said', 'autonomi', 'execut', 'mischaracter', 'revenu', 'low-end', 'hardwar', 'sale', 'softwar', 'sale', 'book', 'licens', 'deal', 'partner', 'revenu', ',', 'even', 'though', 'custom', 'bought', 'product', '.', 'http', ':', '//finviz.com/quote.ashx', '?', 't=hpq']",[3 2 0 ... 0 0 0],5
893,3,"Opportunity with Take-Two Interactive? (Borderlands 2, Bioshock in the pipeline) ",4,1,28,"Hey guys.  I'm still a beginner here, but I wanted to contribute.  Any constructive criticism of my post or idea is welcome.

[TTWO ](http://www.google.com/finance?q=NASDAQ%3ATTWO)

Reasons:
1.They under performed over the last 2 quarters, driving their stock down over 50% since Feb, and lowered their guidance for 2013, and are now in the high $7.8x range from $15 previously, making this an ideal entry point if they move anywhere close to their former glory via these two forthcoming games.

2.  Borderlands 2 looks like it is going to be a pretty big, preorders already placing it above some high-profile games like Red Dead Redemption, Max Payne 3, LA Noire, Bioshock, and Civilization V.   Borderlands 2 is due out on Sept 18th, 45 days from now.

3.  The much-anticipated Bioshock: Infinite is due out this Christmas as well.  The Bioshock game has some large boots to fill, but from initial videos and commentary, it sounds like it might hit the spot. 


What do you guys think?  Buy before $8, ride the Borderlands 2 profit, stay on for the hype and buildup for Bioshock, and then sell off?  Others have mentioned a target of $17 but I don't want to get ahead of myself.  Anything over $10 would be gravy.

First time really posting about playing a stock here, be gentle ;)","['opportun', 'take-two', 'interact', '?', '(', 'borderland', '2', ',', 'bioshock', 'pipelin', ')', 'hey', 'guy', '.', 'i', ""'m"", 'still', 'beginn', ',', 'i', 'want', 'contribut', '.', 'ani', 'construct', 'critic', 'post', 'idea', 'welcom', '.', '[', 'ttwo', ']', '(', 'http', ':', '//www.google.com/fin', '?', 'q=nasdaq', '%', '3attwo', ')', 'reason', ':', '1.they', 'perform', 'last', '2', 'quarter', ',', 'drive', 'stock', '50', '%', 'sinc', 'feb', ',', 'lower', 'guidanc', '2013', ',', 'high', '$', '7.8x', 'rang', '$', '15', 'previous', ',', 'make', 'ideal', 'entri', 'point', 'move', 'anywher', 'close', 'former', 'glori', 'via', 'two', 'forthcom', 'game', '.', '2', '.', 'borderland', '2', 'look', 'like', 'go', 'pretti', 'big', ',', 'preorder', 'alreadi', 'place', 'high-profil', 'game', 'like', 'red', 'dead', 'redempt', ',', 'max', 'payn', '3', ',', 'la', 'noir', ',', 'bioshock', ',', 'civil', 'v.', 'borderland', '2', 'due', 'sept', '18th', ',', '45', 'day', '.', '3', '.', 'the', 'much-anticip', 'bioshock', ':', 'infinit', 'due', 'christma', 'well', '.', 'the', 'bioshock', 'game', 'larg', 'boot', 'fill', ',', 'initi', 'video', 'commentari', ',', 'sound', 'like', 'might', 'hit', 'spot', '.', 'what', 'guy', 'think', '?', 'buy', '$', '8', ',', 'ride', 'borderland', '2', 'profit', ',', 'stay', 'hype', 'buildup', 'bioshock', ',', 'sell', '?', 'other', 'mention', 'target', '$', '17', 'i', ""n't"", 'want', 'get', 'ahead', '.', 'anyth', '$', '10', 'would', 'gravi', '.', 'first', 'time', 'realli', 'post', 'play', 'stock', ',', 'gentl', ';', ')']",[18 11  0 ...  0  0  0],5
709,4,Any thoughts on Morgan Stanley (MS) stock with its recent crash towards a new low?,4,0,2,I've been following MS for awhile now and I believe it's been hovering around its new low since November at around 12.61. Do you guys think there will be a new rally as it hit a new support or will it continue to decline? I haven't heard anything that would boost the MS sales so I was wondering if any of you guys had opinion/insight on the matter. Feel free to share! Thanks.,"['ani', 'thought', 'morgan', 'stanley', '(', 'ms', ')', 'stock', 'recent', 'crash', 'toward', 'new', 'low', '?', 'i', ""'ve"", 'follow', 'ms', 'awhil', 'i', 'believ', ""'s"", 'hover', 'around', 'new', 'low', 'sinc', 'novemb', 'around', '12.61', '.', 'do', 'guy', 'think', 'new', 'ralli', 'hit', 'new', 'support', 'continu', 'declin', '?', 'i', ""n't"", 'heard', 'anyth', 'would', 'boost', 'ms', 'sale', 'i', 'wonder', 'guy', 'opinion/insight', 'matter', '.', 'feel', 'free', 'share', '!', 'thank', '.']",[0 3 0 ... 0 0 0],5
358,6,"Transports continue to under-perform, weighing down the market",7,1,8,,"['transport', 'continu', 'under-perform', ',', 'weigh', 'market', 'nan']",[1 0 0 ... 0 0 0],5
258,8,"$QQQ: Triangle, trade the directional breakout.",11,3,6,,"['$', 'qqq', ':', 'triangl', ',', 'trade', 'direct', 'breakout', '.', 'nan']",[1 1 0 ... 0 0 0],10
744,4,"SPY 5min channel, lets see how far we get",5,1,2,,"['spi', '5min', 'channel', ',', 'let', 'see', 'far', 'get', 'nan']",[1 0 0 ... 0 0 0],5
627,4,Asian stock markets open lower,5,1,0,"Welcome to a new week and a new r/stockmarket!

After the S&amp;P agency downgrades on Friday, the Asian markets are lower at the open.

US markets are closed for MLK day.

WSJ - Asian stock markets dropped Monday as market sentiment weakened significantly after Standard &amp; Poor's lowered its ratings on nine euro-zone nations Friday, while the euro fell to a fresh 11-year low against the Japanese yen.

Standard &amp; Poor's lowered its ratings on nine euro-zone nations including triple-A rated France and Austria, citing insufficient policy initiatives taken by European leaders to address ongoing systemic stresses in the euro zone.

Japan's Nikkei Stock Average was down 1.6%, Australia's S&amp;P/ASX 200 slid 1.0%, South Korea's Kospi Composite lost 1.5%, Hong Kong's Hang Seng Index declined 1.0%, China's Shanghai Composite Index lost 0.6%, India's Sensex was 0.6% lower, and Taiwan's Taiex fell 0.9%. ","['asian', 'stock', 'market', 'open', 'lower', 'welcom', 'new', 'week', 'new', 'r/stockmarket', '!', 'after', 's', '&', 'amp', ';', 'p', 'agenc', 'downgrad', 'friday', ',', 'asian', 'market', 'lower', 'open', '.', 'us', 'market', 'close', 'mlk', 'day', '.', 'wsj', '-', 'asian', 'stock', 'market', 'drop', 'monday', 'market', 'sentiment', 'weaken', 'significantli', 'standard', '&', 'amp', ';', 'poor', ""'s"", 'lower', 'rate', 'nine', 'euro-zon', 'nation', 'friday', ',', 'euro', 'fell', 'fresh', '11-year', 'low', 'japanes', 'yen', '.', 'standard', '&', 'amp', ';', 'poor', ""'s"", 'lower', 'rate', 'nine', 'euro-zon', 'nation', 'includ', 'triple-a', 'rate', 'franc', 'austria', ',', 'cite', 'insuffici', 'polici', 'initi', 'taken', 'european', 'leader', 'address', 'ongo', 'system', 'stress', 'euro', 'zone', '.', 'japan', ""'s"", 'nikkei', 'stock', 'averag', '1.6', '%', ',', 'australia', ""'s"", 's', '&', 'amp', ';', 'p/asx', '200', 'slid', '1.0', '%', ',', 'south', 'korea', ""'s"", 'kospi', 'composit', 'lost', '1.5', '%', ',', 'hong', 'kong', ""'s"", 'hang', 'seng', 'index', 'declin', '1.0', '%', ',', 'china', ""'s"", 'shanghai', 'composit', 'index', 'lost', '0.6', '%', ',', 'india', ""'s"", 'sensex', '0.6', '%', 'lower', ',', 'taiwan', ""'s"", 'taiex', 'fell', '0.9', '%', '.']",[9 5 0 ... 0 0 0],5
632,5,Wedge forming on the 60min ES here,5,0,16,,"['wedg', 'form', '60min', 'es', 'nan']",[0 0 0 ... 0 0 0],5
282,6,How do you think BBRY will behave in June?,8,2,7,"I am wondering aloud if it will have a run up into earnings due to short covering (currently 40% shorted, 5.3 day short ratio). ","['how', 'think', 'bbri', 'behav', 'june', '?', 'i', 'wonder', 'aloud', 'run', 'earn', 'due', 'short', 'cover', '(', 'current', '40', '%', 'short', ',', '5.3', 'day', 'short', 'ratio', ')', '.']",[1 1 0 ... 0 0 0],5
376,6,SEC Uses HFT Firm-Designed Tool To Find That HFT Doesn't Cause Flash Crashes,13,7,2,,"['sec', 'use', 'hft', 'firm-design', 'tool', 'to', 'find', 'that', 'hft', 'doe', ""n't"", 'caus', 'flash', 'crash', 'nan']",[0 0 0 ... 0 0 0],5
384,6,Ditto Trade teams up with Stock Twits for online investing,7,1,3,,"['ditto', 'trade', 'team', 'stock', 'twit', 'onlin', 'invest', 'nan']",[0 0 0 ... 0 0 0],5
224,9,Key events for the week of May 13th,10,1,0,,"['key', 'event', 'week', 'may', '13th', 'nan']",[0 0 0 ... 0 0 0],10
948,4,USD/CHF In Stages,5,1,5,"[Ready](http://i.imgur.com/FXyzE.png)

The level is defined, this will be another setup for me trade. Now we wait for price to reach my level.

[Set](http://i.imgur.com/wwcxA.png)

Price trades into my level as planned, I get short.

[Go!](http://i.imgur.com/992xw.png)

Price reacts out of my level for another profitable trade.

Questions, Comments? Notice the time difference between the ""Ready"" and the ""Set"" charts. An hour passed with me staring at the screen, waiting for the setup to occur (well, I was watching the rest of the markets). Waiting is a large part of trading (for me).

/r/investing told me that profitable trading was impossible, do you reckon they are right?","['usd/chf', 'in', 'stage', '[', 'readi', ']', '(', 'http', ':', '//i.imgur.com/fxyze.png', ')', 'the', 'level', 'defin', ',', 'anoth', 'setup', 'trade', '.', 'now', 'wait', 'price', 'reach', 'level', '.', '[', 'set', ']', '(', 'http', ':', '//i.imgur.com/wwcxa.png', ')', 'price', 'trade', 'level', 'plan', ',', 'i', 'get', 'short', '.', '[', 'go', '!', ']', '(', 'http', ':', '//i.imgur.com/992xw.png', ')', 'price', 'react', 'level', 'anoth', 'profit', 'trade', '.', 'question', ',', 'comment', '?', 'notic', 'time', 'differ', '``', 'readi', ""''"", '``', 'set', ""''"", 'chart', '.', 'an', 'hour', 'pass', 'stare', 'screen', ',', 'wait', 'setup', 'occur', '(', 'well', ',', 'i', 'watch', 'rest', 'market', ')', '.', 'wait', 'larg', 'part', 'trade', '(', ')', '.', '/r/invest', 'told', 'profit', 'trade', 'imposs', ',', 'reckon', 'right', '?']",[6 7 0 ... 0 0 0],5
809,3,The SEC’s Important Case against Stevie Cohen,5,2,0,,"['the', 'sec', '’', 'import', 'case', 'stevi', 'cohen', 'nan']",[0 0 0 ... 0 0 0],5
472,6,Facebook IPO pending,7,1,0,"The time could not be better, the markets are near the highs, sentiment is bullish and AAPL just reported good numbers so tech is strong.

However, the sun is always highest at mid-day! Could this IPO signal a trend change in the market?

We shall soon see.

http://www.bloomberg.com/news/2012-01-27/facebook-may-file-ipo-to-raise-up-to-100-billion-as-early-as-next-week.html

Facebook Inc., the world’s largest social-networking service, is aiming to file for its initial public offering as early as next week, two people with knowledge of the matter said.

The company is discussing a valuation of $75 billion to $100 billion, said two people, who asked not to be identified because the plans haven’t been made public. Timing for the filing is still being discussed and may change, they said.

The IPO would provide funds to help Facebook maintain its expansion and fend off competition from Internet rivals such as Google Inc. (GOOG) and Twitter Inc. The company has discussed raising $10 billion in the offering, a person familiar with the matter said in November. Facebook may set its price at the low end of the valuation range to entice investors and ensure the stock rises after the IPO, said Anupam Palit, an analyst at GreenCrest Capital Management LLC in New York. ","['facebook', 'ipo', 'pend', 'the', 'time', 'could', 'better', ',', 'market', 'near', 'high', ',', 'sentiment', 'bullish', 'aapl', 'report', 'good', 'number', 'tech', 'strong', '.', 'howev', ',', 'sun', 'alway', 'highest', 'mid-day', '!', 'could', 'ipo', 'signal', 'trend', 'chang', 'market', '?', 'we', 'shall', 'soon', 'see', '.', 'http', ':', '//www.bloomberg.com/news/2012-01-27/facebook-may-file-ipo-to-raise-up-to-100-billion-as-early-as-next-week.html', 'facebook', 'inc.', ',', 'world', '’', 'largest', 'social-network', 'servic', ',', 'aim', 'file', 'initi', 'public', 'offer', 'earli', 'next', 'week', ',', 'two', 'peopl', 'knowledg', 'matter', 'said', '.', 'the', 'compani', 'discuss', 'valuat', '$', '75', 'billion', '$', '100', 'billion', ',', 'said', 'two', 'peopl', ',', 'ask', 'identifi', 'plan', '’', 'made', 'public', '.', 'time', 'file', 'still', 'discuss', 'may', 'chang', ',', 'said', '.', 'the', 'ipo', 'would', 'provid', 'fund', 'help', 'facebook', 'maintain', 'expans', 'fend', 'competit', 'internet', 'rival', 'googl', 'inc.', '(', 'goog', ')', 'twitter', 'inc', '.', 'the', 'compani', 'discuss', 'rais', '$', '10', 'billion', 'offer', ',', 'person', 'familiar', 'matter', 'said', 'novemb', '.', 'facebook', 'may', 'set', 'price', 'low', 'end', 'valuat', 'rang', 'entic', 'investor', 'ensur', 'stock', 'rise', 'ipo', ',', 'said', 'anupam', 'palit', ',', 'analyst', 'greencrest', 'capit', 'manag', 'llc', 'new', 'york', '.']",[12  8  0 ...  0  0  0],5
347,8,Apr 26 morning movers,8,0,5,"Out the gates the following stocks are having a big day:

 NFEC	NF Energy Saving Corp	2.78	47.87%

PATK	Patrick Indus	 12.70	42.06%

HZO	Marinemax Inc	 10.92	22.70%

LOGI	Logitech Intl ADR	9.44	21.18%

HUSA	Houston American Energy Corp	2.13	18.33%

IFSIA	Interface Inc'A'    	14.70	18.17%

SWI	Solarwinds Inc	 44.67	18.10%

BCO	The Brink's Company	 25.56	16.18%

STRA	Strayer Education	  99.29	15.21%

CRUS	Cirrus Logic	 26.30	13.88%

","['apr', '26', 'morn', 'mover', 'out', 'gate', 'follow', 'stock', 'big', 'day', ':', 'nfec', 'nf', 'energi', 'save', 'corp', '2.78', '47.87', '%', 'patk', 'patrick', 'indu', '12.70', '42.06', '%', 'hzo', 'marinemax', 'inc', '10.92', '22.70', '%', 'logi', 'logitech', 'intl', 'adr', '9.44', '21.18', '%', 'husa', 'houston', 'american', 'energi', 'corp', '2.13', '18.33', '%', 'ifsia', 'interfac', 'inc', ""'"", 'a', ""'"", '14.70', '18.17', '%', 'swi', 'solarwind', 'inc', '44.67', '18.10', '%', 'bco', 'the', 'brink', ""'s"", 'compani', '25.56', '16.18', '%', 'stra', 'strayer', 'educ', '99.29', '15.21', '%', 'cru', 'cirru', 'logic', '26.30', '13.88', '%']",[0 0 0 ... 0 0 0],10
505,4,IMF World Economic outlook April 2013,5,1,0,,"['imf', 'world', 'econom', 'outlook', 'april', '2013', 'nan']",[0 0 0 ... 0 0 0],5
639,5,"Some people say JPM has a huge Silver short, if they are leaving...does that mean a short squeeze is coming?",6,1,16,"http://www.reuters.com/article/2013/07/27/us-jpmorgan-commoditybusiness-idUSBRE96P10M20130727

Mostly looking for information on whether they still have a silver short, and how big it is. 

","['some', 'peopl', 'say', 'jpm', 'huge', 'silver', 'short', ',', 'leav', '...', 'mean', 'short', 'squeez', 'come', '?', 'http', ':', '//www.reuters.com/article/2013/07/27/us-jpmorgan-commoditybusiness-idusbre96p10m20130727', 'mostli', 'look', 'inform', 'whether', 'still', 'silver', 'short', ',', 'big', '.']",[2 1 0 ... 0 0 0],5
982,3,Solar stocks big movers today,4,1,3,"Right out the gate we have almost all the solar stocks making big moves:

STP	Suntech Power Holdings Co Ltd	3.82	13.35%

FSLR	First Solar Inc	43.87	10.48%

TSL	Trina Solar Ltd	10.05	10.20%

PVA	Penn Virginia	6.23	9.88%

DMD	Demand Media Inc	6.50	9.43%

HSOL	Hanwha SolarOne Co., Ltd.	2.00	9.29%

CSIQ	Canadian Solar Inc	3.90	8.94%

JASO	JA Solar Holdings Co Ltd	2.00	8.11%

JKS	JinkoSolar Hldg Co Ltd	8.75	7.90%
","['solar', 'stock', 'big', 'mover', 'today', 'right', 'gate', 'almost', 'solar', 'stock', 'make', 'big', 'move', ':', 'stp', 'suntech', 'power', 'hold', 'co', 'ltd', '3.82', '13.35', '%', 'fslr', 'first', 'solar', 'inc', '43.87', '10.48', '%', 'tsl', 'trina', 'solar', 'ltd', '10.05', '10.20', '%', 'pva', 'penn', 'virginia', '6.23', '9.88', '%', 'dmd', 'demand', 'media', 'inc', '6.50', '9.43', '%', 'hsol', 'hanwha', 'solaron', 'co.', ',', 'ltd.', '2.00', '9.29', '%', 'csiq', 'canadian', 'solar', 'inc', '3.90', '8.94', '%', 'jaso', 'ja', 'solar', 'hold', 'co', 'ltd', '2.00', '8.11', '%', 'jk', 'jinkosolar', 'hldg', 'co', 'ltd', '8.75', '7.90', '%']",[1 0 0 ... 0 0 0],5
923,2,"MSFT's press conference well-received, Windows 8/new tablet highly anticipated - thoughts on long MSFT?",5,3,19,"In case anyone doesn't care much for or follow tech stocks (they're my bread and butter), MSFT just held a press conference today where they unveiled the new [Surface tablet](https://www.google.com/search?q=surface&amp;ie=utf-8&amp;oe=utf-8&amp;aq=t&amp;rls=org.mozilla:en-US:official&amp;client=firefox-a#q=surface&amp;hl=en&amp;client=firefox-a&amp;hs=JhV&amp;rls=org.mozilla:en-US:official&amp;prmd=imvnsu&amp;source=univ&amp;tbm=nws&amp;tbo=u&amp;sa=X&amp;ei=mfLfT_z4O-ry0gHy-520Dg&amp;ved=0CCYQqAI&amp;bav=on.2,or.r_gc.r_pw.r_cp.r_qf.,cf.osb&amp;fp=325795e3fec301ce&amp;biw=1920&amp;bih=962). Ever since, the community is abuzz with talk of Windows 8 and Surface, with most agreeing that this may finally be the David that takes on AAPL's iPad Goliath. 

Sensationalism aside, I see some good potential for growth - MSFT's been in a steady uptrend since December, some resistance at 33 but it's hovered around the 30s for a good fifty days, with the lowest support level being at 28. ([chart](http://bigcharts.marketwatch.com/advchart/frames/frames.asp?show=&amp;insttype=Stock&amp;symb=MSFT&amp;time=100&amp;startdate=12%2F1%2F2011&amp;enddate=6%2F18%2F2012&amp;freq=1&amp;compidx=aaaaa%3A0&amp;comptemptext=&amp;comp=none&amp;ma=0&amp;maval=9&amp;uf=0&amp;lf=1&amp;lf2=0&amp;lf3=0&amp;type=4&amp;style=320&amp;size=4&amp;x=57&amp;y=7&amp;timeFrameToggle=false&amp;compareToToggle=false&amp;indicatorsToggle=false&amp;chartStyleToggle=false&amp;state=9))

Thoughts from anyone on where we'll see this stock go?","['msft', ""'s"", 'press', 'confer', 'well-receiv', ',', 'window', '8/new', 'tablet', 'highli', 'anticip', '-', 'thought', 'long', 'msft', '?', 'in', 'case', 'anyon', ""n't"", 'care', 'much', 'follow', 'tech', 'stock', '(', ""'re"", 'bread', 'butter', ')', ',', 'msft', 'held', 'press', 'confer', 'today', 'unveil', 'new', '[', 'surfac', 'tablet', ']', '(', 'http', ':', '//www.google.com/search', '?', 'q=surfac', '&', 'amp', ';', 'ie=utf-8', '&', 'amp', ';', 'oe=utf-8', '&', 'amp', ';', 'aq=t', '&', 'amp', ';', 'rls=org.mozilla', ':', 'en-u', ':', 'offici', '&', 'amp', ';', 'client=firefox-a', '#', 'q=surfac', '&', 'amp', ';', 'hl=en', '&', 'amp', ';', 'client=firefox-a', '&', 'amp', ';', 'hs=jhv', '&', 'amp', ';', 'rls=org.mozilla', ':', 'en-u', ':', 'offici', '&', 'amp', ';', 'prmd=imvnsu', '&', 'amp', ';', 'source=univ', '&', 'amp', ';', 'tbm=nw', '&', 'amp', ';', 'tbo=u', '&', 'amp', ';', 'sa=x', '&', 'amp', ';', 'ei=mflft_z4o-ry0ghy-520dg', '&', 'amp', ';', 'ved=0ccyqqai', '&', 'amp', ';', 'bav=on.2', ',', 'or.r_gc.r_pw.r_cp.r_qf.', ',', 'cf.osb', '&', 'amp', ';', 'fp=325795e3fec301c', '&', 'amp', ';', 'biw=1920', '&', 'amp', ';', 'bih=962', ')', '.', 'ever', 'sinc', ',', 'commun', 'abuzz', 'talk', 'window', '8', 'surfac', ',', 'agre', 'may', 'final', 'david', 'take', 'aapl', ""'s"", 'ipad', 'goliath', '.', 'sensation', 'asid', ',', 'i', 'see', 'good', 'potenti', 'growth', '-', 'msft', ""'s"", 'steadi', 'uptrend', 'sinc', 'decemb', ',', 'resist', '33', ""'s"", 'hover', 'around', '30', 'good', 'fifti', 'day', ',', 'lowest', 'support', 'level', '28', '.', '(', '[', 'chart', ']', '(', 'http', ':', '//bigcharts.marketwatch.com/advchart/frames/frames.asp', '?', 'show=', '&', 'amp', ';', 'insttype=stock', '&', 'amp', ';', 'symb=msft', '&', 'amp', ';', 'time=100', '&', 'amp', ';', 'startdate=12', '%', '2f1', '%', '2f2011', '&', 'amp', ';', 'enddate=6', '%', '2f18', '%', '2f2012', '&', 'amp', ';', 'freq=1', '&', 'amp', ';', 'compidx=aaaaa', '%', '3a0', '&', 'amp', ';', 'comptemptext=', '&', 'amp', ';', 'comp=non', '&', 'amp', ';', 'ma=0', '&', 'amp', ';', 'maval=9', '&', 'amp', ';', 'uf=0', '&', 'amp', ';', 'lf=1', '&', 'amp', ';', 'lf2=0', '&', 'amp', ';', 'lf3=0', '&', 'amp', ';', 'type=4', '&', 'amp', ';', 'style=320', '&', 'amp', ';', 'size=4', '&', 'amp', ';', 'x=57', '&', 'amp', ';', 'y=7', '&', 'amp', ';', 'timeframetoggle=fals', '&', 'amp', ';', 'comparetotoggle=fals', '&', 'amp', ';', 'indicatorstoggle=fals', '&', 'amp', ';', 'chartstyletoggle=fals', '&', 'amp', ';', 'state=9', ')', ')', 'thought', 'anyon', ""'ll"", 'see', 'stock', 'go', '?']",[9 3 0 ... 0 0 0],0
900,3,Can anyone recommend a good stock screener?,3,0,7,E*Trade's is a little underwhelming.,"['can', 'anyon', 'recommend', 'good', 'stock', 'screener', '?', 'e', '*', 'trade', ""'s"", 'littl', 'underwhelm', '.']",[0 1 0 ... 0 0 0],5
619,7,Why AAPL will pay a divy,7,0,4,,"['whi', 'aapl', 'pay', 'divi', 'nan']",[0 0 0 ... 0 0 0],5
850,2,"Tom DeMark: ""Sell The World"" And Soon, The US",7,5,7,,"['tom', 'demark', ':', '``', 'sell', 'the', 'world', ""''"", 'and', 'soon', ',', 'the', 'us', 'nan']",[1 0 0 ... 0 0 0],0
645,3,"Im short S&amp;P futures 1652, pray for me!",11,8,66,"I think this rally stinks.

The Fed says they might taper, we tank to 1550.

Then Ben says ""Oh we are just kidding, we will continue to be accommodating as ever!"" and we are suddenly its rally time as if everything is ok!

Why bother with any kind of QE when all you have to do is just say stuff on TV to move the markets the way you want? lol

Yeah yeah, don't fight the Fed, I know.. Im just a sucker for punishment here.
","['im', 'short', 's', '&', 'amp', ';', 'p', 'futur', '1652', ',', 'pray', '!', 'i', 'think', 'ralli', 'stink', '.', 'the', 'fed', 'say', 'might', 'taper', ',', 'tank', '1550', '.', 'then', 'ben', 'say', '``', 'oh', 'kid', ',', 'continu', 'accommod', 'ever', '!', ""''"", 'suddenli', 'ralli', 'time', 'everyth', 'ok', '!', 'whi', 'bother', 'kind', 'qe', 'say', 'stuff', 'tv', 'move', 'market', 'way', 'want', '?', 'lol', 'yeah', 'yeah', ',', ""n't"", 'fight', 'fed', ',', 'i', 'know', '..', 'im', 'sucker', 'punish', '.']",[5 3 0 ... 0 0 0],5
841,3,"236,000 new February jobs, Jan and Dec revised up. Unemployment 7.7%",3,0,0,,"['236,000', 'new', 'februari', 'job', ',', 'jan', 'dec', 'revis', '.', 'unemploy', '7.7', '%', 'nan']",[1 1 0 ... 0 0 0],5
556,4,"Next Week’s Tape: Retailer Earnings, and Housing Soundings",5,1,0,,"['next', 'week', '’', 'tape', ':', 'retail', 'earn', ',', 'hous', 'sound', 'nan']",[1 0 0 ... 0 0 0],5
952,3,Who went long AAPL at $644 today?,5,2,9,"You know somebody had the honor of buying this intermediate high.

AAPL finally feeling some gravity and joining the rest of the market, $627 here, not your usual +$10 gain today.

This stock needs  a good flush to remind everybody that the stock market is not the same as a high interest bank account where money goes in and comes out a week later in the green.","['who', 'went', 'long', 'aapl', '$', '644', 'today', '?', 'you', 'know', 'somebodi', 'honor', 'buy', 'intermedi', 'high', '.', 'aapl', 'final', 'feel', 'graviti', 'join', 'rest', 'market', ',', '$', '627', ',', 'usual', '+', '$', '10', 'gain', 'today', '.', 'thi', 'stock', 'need', 'good', 'flush', 'remind', 'everybodi', 'stock', 'market', 'high', 'interest', 'bank', 'account', 'money', 'goe', 'come', 'week', 'later', 'green', '.']",[2 3 0 ... 0 0 0],5
577,7,TWC trading,8,1,2,"I don't know much about trading, but I was browsing and found this and was curious how this worked. 
TWC CEO buys shares cheap then sells them the same day?
Did she really make nearly 3.4 million in one day?

[www.reuters.com](http://www.reuters.com/finance/stocks/insiderTrading?symbol=TWC&amp;name=&amp;pn=2&amp;sortDir=&amp;sortBy=)

[http://imgur.com/roZHw
](http://imgur.com/roZHw)

","['twc', 'trade', 'i', ""n't"", 'know', 'much', 'trade', ',', 'i', 'brows', 'found', 'curiou', 'work', '.', 'twc', 'ceo', 'buy', 'share', 'cheap', 'sell', 'day', '?', 'did', 'realli', 'make', 'nearli', '3.4', 'million', 'one', 'day', '?', '[', 'www.reuters.com', ']', '(', 'http', ':', '//www.reuters.com/finance/stocks/insidertrad', '?', 'symbol=twc', '&', 'amp', ';', 'name=', '&', 'amp', ';', 'pn=2', '&', 'amp', ';', 'sortdir=', '&', 'amp', ';', 'sortby=', ')', '[', 'http', ':', '//imgur.com/rozhw', ']', '(', 'http', ':', '//imgur.com/rozhw', ')']",[1 1 0 ... 0 0 0],5
795,4,AAPLs To AAPLs: Not All iEarnings Are Created Equal,4,0,4,,"['aapl', 'to', 'aapl', ':', 'not', 'all', 'iearn', 'are', 'creat', 'equal', 'nan']",[0 0 0 ... 0 0 0],5
85,14,QQQ Chart Porn.,16,2,8,,"['qqq', 'chart', 'porn', '.', 'nan']",[0 1 0 ... 0 0 0],15
242,8,Tripadvisor up nearly 20% premarket.  ,10,2,1,I am so glad I held through earnings :D,"['tripadvisor', 'nearli', '20', '%', 'premarket', '.', 'i', 'glad', 'i', 'held', 'earn', ':', 'd']",[0 1 0 ... 0 0 0],10
698,5,"U.S. Banks told to make ""Recovery Plans""",6,1,2,,"['u.s.', 'bank', 'told', 'make', '``', 'recoveri', 'plan', ""''"", 'nan']",[0 0 0 ... 0 0 0],5
159,9,Here we go...,10,1,13,,"['here', 'go', '...', 'nan']",[0 0 0 ... 0 0 0],10
524,5,"Stock Jocke, what say you follow Bill Ackman and Einhorn or go long ?",7,2,15,,"['stock', 'jock', ',', 'say', 'follow', 'bill', 'ackman', 'einhorn', 'go', 'long', '?', 'nan']",[1 0 0 ... 0 0 0],5
35,16,"TSLA holding up like a champ, but very overbought here.",18,2,12,,"['tsla', 'hold', 'like', 'champ', ',', 'overbought', '.', 'nan']",[1 1 0 ... 0 0 0],15
540,4,Expedia up %14 after hours.,5,1,0,"This is a good omen for the travel sector!  Despite the economy, it looks like people are still traveling.","['expedia', '%', '14', 'hour', '.', 'thi', 'good', 'omen', 'travel', 'sector', '!', 'despit', 'economi', ',', 'look', 'like', 'peopl', 'still', 'travel', '.']",[1 2 0 ... 0 0 0],5
170,8,1630-1640 this week? Im sure CNBC will be celebrating a close over the 50dma,10,2,6,,"['1630-1640', 'week', '?', 'im', 'sure', 'cnbc', 'celebr', 'close', '50dma', 'nan']",[0 0 0 ... 0 0 0],10
654,3,Two days in the Dow -- the market will fluctuate...,7,4,0,"Two days ago, all 30 of the Dow stocks were up and 19 of the top 20 weighted stocks in the NDX on an evident bears' capitulation to the four-day surge out of the 6/12 low.  If market breadth could not advance through the Fed (it didn't), it was likely going to be ""sell the news"" (and so it was).

If one's a swing trader or market timer, me thinks one has to pay attention to things like this.

So now what? The mirror opposite. All 30 Dow stocks were down today and the same for the top 20 NDX stocks. I follow 50 stocks at all times that I call my ""nifty-fifty"" stocks and that list is signaling bounce time (or at least alerting that a bounce can come any minute). Personally, I'd prefer a couple more days down on the Nasdaq Comp, not necessarily as hard as today's drop, but two more because four consecutive days down (or more) very often mark a significant swing bottom. Haven't had a four-day decline in the Naz this year, even three days down in a row has been hard to come by...so tomorrow...probably bounce time.

","['two', 'day', 'dow', '--', 'market', 'fluctuat', '...', 'two', 'day', 'ago', ',', '30', 'dow', 'stock', '19', 'top', '20', 'weight', 'stock', 'ndx', 'evid', 'bear', ""'"", 'capitul', 'four-day', 'surg', '6/12', 'low', '.', 'if', 'market', 'breadth', 'could', 'advanc', 'fed', '(', ""n't"", ')', ',', 'like', 'go', '``', 'sell', 'news', ""''"", '(', ')', '.', 'if', 'one', ""'s"", 'swing', 'trader', 'market', 'timer', ',', 'think', 'one', 'pay', 'attent', 'thing', 'like', '.', 'so', '?', 'the', 'mirror', 'opposit', '.', 'all', '30', 'dow', 'stock', 'today', 'top', '20', 'ndx', 'stock', '.', 'i', 'follow', '50', 'stock', 'time', 'i', 'call', '``', 'nifty-fifti', ""''"", 'stock', 'list', 'signal', 'bounc', 'time', '(', 'least', 'alert', 'bounc', 'come', 'minut', ')', '.', 'person', ',', 'i', ""'d"", 'prefer', 'coupl', 'day', 'nasdaq', 'comp', ',', 'necessarili', 'hard', 'today', ""'s"", 'drop', ',', 'two', 'four', 'consecut', 'day', '(', ')', 'often', 'mark', 'signific', 'swing', 'bottom', '.', 'have', ""n't"", 'four-day', 'declin', 'naz', 'year', ',', 'even', 'three', 'day', 'row', 'hard', 'come', '...', 'tomorrow', '...', 'probabl', 'bounc', 'time', '.']",[7 8 0 ... 0 0 0],5
885,3,"Marks Weekly Trading Log!
Compilation of Charts and Analysis.",5,2,1,,"['mark', 'weekli', 'trade', 'log', '!', 'compil', 'chart', 'analysi', '.', 'nan']",[0 1 0 ... 0 0 0],5
852,2,Technical Update: AAPL &amp; NFLX 1.8.2013,10,8,0,,"['technic', 'updat', ':', 'aapl', '&', 'amp', ';', 'nflx', '1.8.2013', 'nan']",[0 0 0 ... 0 0 0],0
842,3,"Stocks up on economic hopes, but copper down.",3,0,6,,"['stock', 'econom', 'hope', ',', 'copper', '.', 'nan']",[1 1 0 ... 0 0 0],5
939,4,FB IPO live chat now ,6,2,17,"Quick and painless registration required.

FB IPO chat now taking place:

http://www.hotstockmarket.com/chat/

","['fb', 'ipo', 'live', 'chat', 'quick', 'painless', 'registr', 'requir', '.', 'fb', 'ipo', 'chat', 'take', 'place', ':', 'http', ':', '//www.hotstockmarket.com/chat/']",[0 1 0 ... 0 0 0],5
733,3,Lithium stocks at a all time high. I'm in!,5,2,6,,"['lithium', 'stock', 'time', 'high', '.', 'i', ""'m"", '!', 'nan']",[0 1 0 ... 0 0 0],5
95,12,Russians have $40B in Cyprus,15,3,3,,"['russian', '$', '40b', 'cypru', 'nan']",[0 0 0 ... 0 0 0],10
563,6,Global economic surprises continue to diverge from S&amp;P,6,0,3,,"['global', 'econom', 'surpris', 'continu', 'diverg', 's', '&', 'amp', ';', 'p', 'nan']",[0 0 0 ... 0 0 0],5
240,7,Mark's Weekly Log; Charts and Analysis.,9,2,1,,"['mark', ""'s"", 'weekli', 'log', ';', 'chart', 'analysi', '.', 'nan']",[0 1 0 ... 0 0 0],5
742,4,"Spain Agrees To ""Unconditonal"" Bank Bailout ",7,3,8,,"['spain', 'agre', 'to', '``', 'unconditon', ""''"", 'bank', 'bailout', 'nan']",[0 0 0 ... 0 0 0],5
574,5,"Wedge pattern forming on C, plus its near its 2 year support level",7,2,4,,"['wedg', 'pattern', 'form', 'c', ',', 'plu', 'near', '2', 'year', 'support', 'level', 'nan']",[1 0 0 ... 0 0 0],5
690,3,"QCOR story stock of the day, -40% hit from short sellers report",5,2,12,,"['qcor', 'stori', 'stock', 'day', ',', '-40', '%', 'hit', 'short', 'seller', 'report', 'nan']",[1 0 0 ... 0 0 0],5
460,6,Facebook to list on the NASDAQ,7,1,10,"WSJ - Nasdaq shares are getting a lift this afternoon after CNBC reported Facebook has decided to list its stock on the tech-heavy exchange.

Nasdaq representatives weren’t immediately available for comment.

Nasdaq shares recently rose 1.5% to $25.59. Meanwhile, NYSE Euronext dropped 1.4% to $28.28.","['facebook', 'list', 'nasdaq', 'wsj', '-', 'nasdaq', 'share', 'get', 'lift', 'afternoon', 'cnbc', 'report', 'facebook', 'decid', 'list', 'stock', 'tech-heavi', 'exchang', '.', 'nasdaq', 'repres', '’', 'immedi', 'avail', 'comment', '.', 'nasdaq', 'share', 'recent', 'rose', '1.5', '%', '$', '25.59', '.', 'meanwhil', ',', 'nyse', 'euronext', 'drop', '1.4', '%', '$', '28.28', '.']",[1 4 0 ... 0 0 0],5
553,5,What's everybody looking forward to this week?,6,1,4,"[this week's schedule](http://biz.yahoo.com/c/ec/201235.html)

I'm thinking we'll get some positive surprises this week. Don't know what to expect with GDP or Consumer Confidence though but I think we'll get some good jobs numbers. I'm hoping for a green week","['what', ""'s"", 'everybodi', 'look', 'forward', 'week', '?', '[', 'week', ""'s"", 'schedul', ']', '(', 'http', ':', '//biz.yahoo.com/c/ec/201235.html', ')', 'i', ""'m"", 'think', ""'ll"", 'get', 'posit', 'surpris', 'week', '.', 'do', ""n't"", 'know', 'expect', 'gdp', 'consum', 'confid', 'though', 'i', 'think', ""'ll"", 'get', 'good', 'job', 'number', '.', 'i', ""'m"", 'hope', 'green', 'week']",[0 2 0 ... 0 0 0],5
873,3,MNST not such a pretty takeover target anymore,3,0,0,,"['mnst', 'pretti', 'takeov', 'target', 'anymor', 'nan']",[0 0 0 ... 0 0 0],5
206,11,"BAC +5%, MS+3%, GS +3% banks on the move this morning",11,0,11,"Buyers stampeding over each other to get into financial stocks this morning.

Julius Baer is in talks with Bank of America about buying Merrill Lynch's non-US wealth management unit, reported to be worth up to $2 billion and which would see the acquisition-hungry Swiss private bank land another big deal. Bank of America shares gained 0.8 per cent to $7.82 premarket. ","['bac', '+5', '%', ',', 'ms+3', '%', ',', 'gs', '+3', '%', 'bank', 'move', 'morn', 'buyer', 'stamped', 'get', 'financi', 'stock', 'morn', '.', 'juliu', 'baer', 'talk', 'bank', 'america', 'buy', 'merril', 'lynch', ""'s"", 'non-u', 'wealth', 'manag', 'unit', ',', 'report', 'worth', '$', '2', 'billion', 'would', 'see', 'acquisition-hungri', 'swiss', 'privat', 'bank', 'land', 'anoth', 'big', 'deal', '.', 'bank', 'america', 'share', 'gain', '0.8', 'per', 'cent', '$', '7.82', 'premarket', '.']",[3 3 0 ... 0 0 0],10
392,8,New all time highs for Hershey,10,2,1,,"['new', 'time', 'high', 'hershey', 'nan']",[0 0 0 ... 0 0 0],10
794,5,What stocks?(VSE),5,0,13,"Hi r/SM, I was wondering if you could help me.  I am doing a Virtual Stock Exchange project for school, we started with 100k and I'm in 15th out of 30 now, what stocks should I buy and how much?
edit: I practically know nothing about the Stock Market so telling me which ones to buy is helpful and appreciated :)","['what', 'stock', '?', '(', 'vse', ')', 'hi', 'r/sm', ',', 'i', 'wonder', 'could', 'help', '.', 'i', 'virtual', 'stock', 'exchang', 'project', 'school', ',', 'start', '100k', 'i', ""'m"", '15th', '30', ',', 'stock', 'i', 'buy', 'much', '?', 'edit', ':', 'i', 'practic', 'know', 'noth', 'stock', 'market', 'tell', 'one', 'buy', 'help', 'appreci', ':', ')']",[3 1 0 ... 0 0 0],5
397,5,Mark's Weekly Trading Log (2/18-2/22) Charts and Analysis,8,3,0,,"['mark', ""'s"", 'weekli', 'trade', 'log', '(', '2/18-2/22', ')', 'chart', 'analysi', 'nan']",[0 0 0 ... 0 0 0],5
766,4,"CITI (C) earnings report tomorrow. High expectations, thoughts? ",4,0,6,"Listen in or view a live webcast of the conference [HERE](http://www.citigroup.com/citi/news/2012/120224a.htm)

The last earnings came in at .38 and the consensus estimate is over 2.5x that amount at 1.012

From a technical standpoint this stock is in a GREAT short sell position so I'm looking for the price to fall.  Ask me and I can let you know why I feel this way.  

Does listening in to the conference call for a lower than expected report (if it happens) give me any chance to profit?  Or will the stock automatically open at the proper reflective price when the market opens an hour later?  

I feel like this could be a good short for the short term at least, and I'm interested in hearing other opinions.

","['citi', '(', 'c', ')', 'earn', 'report', 'tomorrow', '.', 'high', 'expect', ',', 'thought', '?', 'listen', 'view', 'live', 'webcast', 'confer', '[', 'here', ']', '(', 'http', ':', '//www.citigroup.com/citi/news/2012/120224a.htm', ')', 'the', 'last', 'earn', 'came', '.38', 'consensu', 'estim', '2.5x', 'amount', '1.012', 'from', 'technic', 'standpoint', 'stock', 'great', 'short', 'sell', 'posit', 'i', ""'m"", 'look', 'price', 'fall', '.', 'ask', 'i', 'let', 'know', 'i', 'feel', 'way', '.', 'doe', 'listen', 'confer', 'call', 'lower', 'expect', 'report', '(', 'happen', ')', 'give', 'chanc', 'profit', '?', 'or', 'stock', 'automat', 'open', 'proper', 'reflect', 'price', 'market', 'open', 'hour', 'later', '?', 'i', 'feel', 'like', 'could', 'good', 'short', 'short', 'term', 'least', ',', 'i', ""'m"", 'interest', 'hear', 'opinion', '.']",[2 4 0 ... 0 0 0],5
843,3,Dow reaches record highs on optimism about economy,6,3,7,,"['dow', 'reach', 'record', 'high', 'optim', 'economi', 'nan']",[0 0 0 ... 0 0 0],5
217,7,Ready for 3% on the 10yr sooner than later?,10,3,4,,"['readi', '3', '%', '10yr', 'sooner', 'later', '?', 'nan']",[0 0 0 ... 0 0 0],5
4,30,"90% of people who try Options trading lose money and quit in the first year, after blowing through their account. Here's how to avoid that",51,21,34," What most people don't understand is that Options, unlike any other financial instrument has a very steep learning curve. Getting the basics right is probably the most important step. Snake-oil sales pitches from dubious players promising fantastic returns are another reason many people go the wrong direction. If you're thinking about Options or want to learn more about them, I've created this no-nonsense Udemy course. No hype, no fluff..just pure high-quality education on the fundamentals of Call Options and Put Options...ENJOY !! Use this link to reserve your free copy - https://www.udemy.com/learn-options-trading-introduction-call-put-options/?couponCode=REDDITOptions","['90', '%', 'peopl', 'tri', 'option', 'trade', 'lose', 'money', 'quit', 'first', 'year', ',', 'blow', 'account', '.', 'here', ""'s"", 'avoid', 'what', 'peopl', ""n't"", 'understand', 'option', ',', 'unlik', 'financi', 'instrument', 'steep', 'learn', 'curv', '.', 'get', 'basic', 'right', 'probabl', 'import', 'step', '.', 'snake-oil', 'sale', 'pitch', 'dubiou', 'player', 'promis', 'fantast', 'return', 'anoth', 'reason', 'mani', 'peopl', 'go', 'wrong', 'direct', '.', 'if', ""'re"", 'think', 'option', 'want', 'learn', ',', 'i', ""'ve"", 'creat', 'no-nonsens', 'udemi', 'cours', '.', 'no', 'hype', ',', 'fluff', '..', 'pure', 'high-qual', 'educ', 'fundament', 'call', 'option', 'put', 'option', '...', 'enjoy', '!', '!', 'use', 'link', 'reserv', 'free', 'copi', '-', 'http', ':', '//www.udemy.com/learn-options-trading-introduction-call-put-options/', '?', 'couponcode=redditopt']",[4 5 0 ... 0 0 0],30
768,5,Russell taking out yesterdays support. Small caps leading lower,5,0,1,"http://finviz.com/futures_charts.ashx?t=ER2&amp;p=m5

I like to watch the small cap index for clues, they often tend to lead to the downside as hot money flees the most speculative stocks first.","['russel', 'take', 'yesterday', 'support', '.', 'small', 'cap', 'lead', 'lower', 'http', ':', '//finviz.com/futures_charts.ashx', '?', 't=er2', '&', 'amp', ';', 'p=m5', 'i', 'like', 'watch', 'small', 'cap', 'index', 'clue', ',', 'often', 'tend', 'lead', 'downsid', 'hot', 'money', 'flee', 'specul', 'stock', 'first', '.']",[1 2 0 ... 0 0 0],5
642,5,"GM profit beats on strong U.S. demand, smaller loss in Europe",6,1,0,,"['gm', 'profit', 'beat', 'strong', 'u.s.', 'demand', ',', 'smaller', 'loss', 'europ', 'nan']",[1 0 0 ... 0 0 0],5
892,3,Any word on the GoGo IPO announced last December?,3,0,2,"I know I've asked this on here before, just seeing if anybody has any new information. ","['ani', 'word', 'gogo', 'ipo', 'announc', 'last', 'decemb', '?', 'i', 'know', 'i', ""'ve"", 'ask', ',', 'see', 'anybodi', 'new', 'inform', '.']",[1 1 0 ... 0 0 0],5
612,6,Trading the news.,6,0,10,"The key to trading the news is to not think about what the news means, rather to think about how the market reacts to the news.  Rule number 1.  the market is always right.  Smart money waits for the news to be digested by the market and lets Mr. Market tell them what it thinks before taking a position, retail gets in early on anticipation of the news event thinking it will go one way or another way *while in reality, retail has no way of knowing which way it will go until it goes and will be at the mercy of whatever Mr. Market decides*

Key example 1:  Greece ""default"".  We all knew it was coming, it was structured in a good way and the market has blown through most resistance levels on the chart and is probably going for high of the year, the market reacted to the issue last fall, and then shrugged it off, and has gone higher ever since. 

Key example 2:  Simple chart to determine when to get in after the news, where to put stops.  Here is GMCR chart from yesterday:

http://stockcharts.com/h-sc/ui?s=GMCR&amp;p=5&amp;b=6&amp;g=0&amp;id=p48992316031&amp;a=260499568

See on the chart, how we opened at low and retraced to high before staying somewhere between all day?  That sets the high and low as resistance ad support, market has not yet made up it's mind which way it wants to go yet, when it breaks one of those lines, that is most likely which way it will go.  Wait for the break of one of those lines, and then trade in direction of break, with stop at break.


Disclosure:  I took my first long term hold position of the year on the recovery of the pullback from last week, I anticipate the market is not done going higher yet due to the hard and fast recovery, if I am wrong, I am wrong and the market was right, I have stops set at the lows of the pullback just in case.

I anticipate another good week coming up!","['trade', 'news', '.', 'the', 'key', 'trade', 'news', 'think', 'news', 'mean', ',', 'rather', 'think', 'market', 'react', 'news', '.', 'rule', 'number', '1.', 'market', 'alway', 'right', '.', 'smart', 'money', 'wait', 'news', 'digest', 'market', 'let', 'mr.', 'market', 'tell', 'think', 'take', 'posit', ',', 'retail', 'get', 'earli', 'anticip', 'news', 'event', 'think', 'go', 'one', 'way', 'anoth', 'way', '*', 'realiti', ',', 'retail', 'way', 'know', 'way', 'go', 'goe', 'merci', 'whatev', 'mr.', 'market', 'decid', '*', 'key', 'exampl', '1', ':', 'greec', '``', 'default', ""''"", '.', 'we', 'knew', 'come', ',', 'structur', 'good', 'way', 'market', 'blown', 'resist', 'level', 'chart', 'probabl', 'go', 'high', 'year', ',', 'market', 'react', 'issu', 'last', 'fall', ',', 'shrug', ',', 'gone', 'higher', 'ever', 'sinc', '.', 'key', 'exampl', '2', ':', 'simpl', 'chart', 'determin', 'get', 'news', ',', 'put', 'stop', '.', 'here', 'gmcr', 'chart', 'yesterday', ':', 'http', ':', '//stockcharts.com/h-sc/ui', '?', 's=gmcr', '&', 'amp', ';', 'p=5', '&', 'amp', ';', 'b=6', '&', 'amp', ';', 'g=0', '&', 'amp', ';', 'id=p48992316031', '&', 'amp', ';', 'a=260499568', 'see', 'chart', ',', 'open', 'low', 'retrac', 'high', 'stay', 'somewher', 'day', '?', 'that', 'set', 'high', 'low', 'resist', 'ad', 'support', ',', 'market', 'yet', 'made', ""'s"", 'mind', 'way', 'want', 'go', 'yet', ',', 'break', 'one', 'line', ',', 'like', 'way', 'go', '.', 'wait', 'break', 'one', 'line', ',', 'trade', 'direct', 'break', ',', 'stop', 'break', '.', 'disclosur', ':', 'i', 'took', 'first', 'long', 'term', 'hold', 'posit', 'year', 'recoveri', 'pullback', 'last', 'week', ',', 'i', 'anticip', 'market', 'done', 'go', 'higher', 'yet', 'due', 'hard', 'fast', 'recoveri', ',', 'i', 'wrong', ',', 'i', 'wrong', 'market', 'right', ',', 'i', 'stop', 'set', 'low', 'pullback', 'case', '.', 'i', 'anticip', 'anoth', 'good', 'week', 'come', '!']",[18  9  0 ...  0  0  0],5
738,3,$1B Greek bank runs,4,1,0,,"['$', '1b', 'greek', 'bank', 'run', 'nan']",[0 0 0 ... 0 0 0],5
546,4,Bank stocks drag Wall Street lower after earnings,5,1,0,,"['bank', 'stock', 'drag', 'wall', 'street', 'lower', 'earn', 'nan']",[0 0 0 ... 0 0 0],5
725,3,Stock Market Today: Biggest % movers July 5th,5,2,9,"Futures are down at the moment as some air deflates from the Eurozone inspired rally of the past few session.

Topping the list of the big movers is... PCX!

PCX	Patriot Coal Corp	2.30	25.00%

YELP	Yelp Inc	27.14	9.79%

VC	Visteon Corporation	40.14	7.96%

JRCC	James River Coal Co	3.39	7.88%

UVXY	ProShares Ultra VIX Short-Term	8.80	7.58%

OSUR	Orasure Technologies	13.00	7.44%

NFLX	Netflix Inc	77.25	7.23%

CHU	China Unicom ADS	13.66	6.89%

DSLV	VS 3X Inverse Silver	42.25	6.42%

TVIX	VS 2X VIX Short Term	4.30	5.91%

","['stock', 'market', 'today', ':', 'biggest', '%', 'mover', 'juli', '5th', 'futur', 'moment', 'air', 'deflat', 'eurozon', 'inspir', 'ralli', 'past', 'session', '.', 'top', 'list', 'big', 'mover', '...', 'pcx', '!', 'pcx', 'patriot', 'coal', 'corp', '2.30', '25.00', '%', 'yelp', 'yelp', 'inc', '27.14', '9.79', '%', 'vc', 'visteon', 'corpor', '40.14', '7.96', '%', 'jrcc', 'jame', 'river', 'coal', 'co', '3.39', '7.88', '%', 'uvxi', 'proshar', 'ultra', 'vix', 'short-term', '8.80', '7.58', '%', 'osur', 'orasur', 'technolog', '13.00', '7.44', '%', 'nflx', 'netflix', 'inc', '77.25', '7.23', '%', 'chu', 'china', 'unicom', 'ad', '13.66', '6.89', '%', 'dslv', 'vs', '3x', 'invers', 'silver', '42.25', '6.42', '%', 'tvix', 'vs', '2x', 'vix', 'short', 'term', '4.30', '5.91', '%']",[0 1 0 ... 0 0 0],5
683,4,TRIP down nearly 1/3 from its July high.,4,0,3,"I am sad to say I bought quite a few shares at $35.  As TRIP continues to sink 3% today while the rest of the market climbs, I'm open to opinions as to where this one is going.","['trip', 'nearli', '1/3', 'juli', 'high', '.', 'i', 'sad', 'say', 'i', 'bought', 'quit', 'share', '$', '35', '.', 'as', 'trip', 'continu', 'sink', '3', '%', 'today', 'rest', 'market', 'climb', ',', 'i', ""'m"", 'open', 'opinion', 'one', 'go', '.']",[1 3 0 ... 0 0 0],5
98,11,AAPL trade idea: Sell naked Dec 580 puts,13,2,16,,"['aapl', 'trade', 'idea', ':', 'sell', 'nake', 'dec', '580', 'put', 'nan']",[0 0 0 ... 0 0 0],10
804,3,What is the 'J' following the stock symbol in the SPY option symbols?,3,0,1,"Sorry for the cross post - I also submitted to AskReddit.

I know that the '7' now means a mini contract, but I see no explanation for the 'J'.","['what', ""'"", 'j', ""'"", 'follow', 'stock', 'symbol', 'spi', 'option', 'symbol', '?', 'sorri', 'cross', 'post', '-', 'i', 'also', 'submit', 'askreddit', '.', 'i', 'know', ""'"", '7', ""'"", 'mean', 'mini', 'contract', ',', 'i', 'see', 'explan', ""'"", 'j', ""'"", '.']",[1 2 0 ... 0 0 0],5
727,4,Chart! S&amp;P Daily Round Bottom/Cup and Handle,4,0,5,"link to chart:
http://www.hotstockmarket.com/image/id/362636","['chart', '!', 's', '&', 'amp', ';', 'p', 'daili', 'round', 'bottom/cup', 'handl', 'link', 'chart', ':', 'http', ':', '//www.hotstockmarket.com/image/id/362636']",[0 0 0 ... 0 0 0],5
573,3,Stock Market Today: Biggest % movers June 29th,5,2,2,"With the markets up strong this morning, here is the list of the top 10 movers as of 10:45am:


AMPE	Ampio Pharmaceuticals Inc	5.15	30.71%

STZ	Constellation Brands 'A'	26.46	21.60%

SNTA	Synta Pharmaceuticals Inc	5.54	14.98%

AZZ	AZZ Incorporated	58.31	13.62%

SWHC	Smith &amp; Wesson Holding Corp	7.82	13.50%

VCLK	Valueclick Inc	15.89	12.66%

USLV	VS 3X Silver	21.75	11.77%

TAHO	Tahoe Resources Inc	13.37	11.20%

EDC	Emerging Markets Bull 3x Shs	76.18	10.72%

SOXL	DXN DLY Second 3X BL	27.62	10.22%

Check out Smith &amp; Wesson making a nice move here, also TIL there is a company named AZZ.
","['stock', 'market', 'today', ':', 'biggest', '%', 'mover', 'june', '29th', 'with', 'market', 'strong', 'morn', ',', 'list', 'top', '10', 'mover', '10:45am', ':', 'amp', 'ampio', 'pharmaceut', 'inc', '5.15', '30.71', '%', 'stz', 'constel', 'brand', ""'"", ""a'"", '26.46', '21.60', '%', 'snta', 'synta', 'pharmaceut', 'inc', '5.54', '14.98', '%', 'azz', 'azz', 'incorpor', '58.31', '13.62', '%', 'swhc', 'smith', '&', 'amp', ';', 'wesson', 'hold', 'corp', '7.82', '13.50', '%', 'vclk', 'valueclick', 'inc', '15.89', '12.66', '%', 'uslv', 'vs', '3x', 'silver', '21.75', '11.77', '%', 'taho', 'taho', 'resourc', 'inc', '13.37', '11.20', '%', 'edc', 'emerg', 'market', 'bull', '3x', 'sh', '76.18', '10.72', '%', 'soxl', 'dxn', 'dli', 'second', '3x', 'bl', '27.62', '10.22', '%', 'check', 'smith', '&', 'amp', ';', 'wesson', 'make', 'nice', 'move', ',', 'also', 'til', 'compani', 'name', 'azz', '.']",[2 1 0 ... 0 0 0],5
406,6,"Best Buy Board, Schulze Agree to Extend Bid Deadline. Stock loses 12%",6,0,0,,"['best', 'buy', 'board', ',', 'schulz', 'agre', 'extend', 'bid', 'deadlin', '.', 'stock', 'lose', '12', '%', 'nan']",[1 1 0 ... 0 0 0],5
502,4,Boeing is the new hedge fund favorite,15,11,4,,"['boe', 'new', 'hedg', 'fund', 'favorit', 'nan']",[0 0 0 ... 0 0 0],5
47,14,"Insider trading sparks concerns - Universities indulge researchers’ ties to finance industry. “The only reason anybody wants to talk to you from a financial company is for insider information,”  “That’s the start of the story and that’s the end of the story.”",16,2,1,,"['insid', 'trade', 'spark', 'concern', '-', 'univers', 'indulg', 'research', '’', 'tie', 'financ', 'industri', '.', '“', 'the', 'reason', 'anybodi', 'want', 'talk', 'financi', 'compani', 'insid', 'inform', ',', '”', '“', 'that', '’', 'start', 'stori', '’', 'end', 'story.', '”', 'nan']",[1 1 0 ... 0 0 0],15
32,17,How To Take Advantage Of The Market Pulling Back,19,2,6,,"['how', 'to', 'take', 'advantag', 'of', 'the', 'market', 'pull', 'back', 'nan']",[0 0 0 ... 0 0 0],15
779,3,Chart voodoo for March - S&amp;P resistance 1400 next?,4,1,5,"Its a beautiful spring day outside, the sun is shining, birds are chirping... and Im looking at the S&amp;P chart.

http://i.imgur.com/KTygl.gif

Back in Oct we saw one of the strongest reversal rallies in years. If you remember, we were all freaking out about riots in Greece and how the dominoes would start to fall as soon as Greece defaults.

That was Oct 4th, the day the panic was at its highest. We had a huge reversal in trend that day and the market soared 200 points over the next 3 weeks. 

Using the high and low of that powerful rally, I extended some fib levels outward and as you can see they cleanly set the support and resistance levels on the most recent high and sell off.

I liked this set up and I got some bear ETFs like SDS and FAZ in hopes that this was a more permanent resistance level up at 1374. Right now it looks like we may push above it, which to me, indicates an attempt at the 1400 level, which makes my SDS very sad. :P

1400 is interesting. Not only is it a psychological level (think Dow 13,000 and what a stink CNBC makes about it, S&amp;P 1400 is more important because the S&amp;P has 500 stocks in it, not 30 like the Dow), but its also the next fibonacci level.

Also pay attention to that rising wedge since Oct, the apex is nearing. Bears really do not have much to go on here except for a potential break below the wedge or below 1340, which ever comes first. That is the line in the sand for any technical trader.


","['chart', 'voodoo', 'march', '-', 's', '&', 'amp', ';', 'p', 'resist', '1400', 'next', '?', 'it', 'beauti', 'spring', 'day', 'outsid', ',', 'sun', 'shine', ',', 'bird', 'chirp', '...', 'im', 'look', 's', '&', 'amp', ';', 'p', 'chart', '.', 'http', ':', '//i.imgur.com/ktygl.gif', 'back', 'oct', 'saw', 'one', 'strongest', 'revers', 'ralli', 'year', '.', 'if', 'rememb', ',', 'freak', 'riot', 'greec', 'domino', 'would', 'start', 'fall', 'soon', 'greec', 'default', '.', 'that', 'oct', '4th', ',', 'day', 'panic', 'highest', '.', 'we', 'huge', 'revers', 'trend', 'day', 'market', 'soar', '200', 'point', 'next', '3', 'week', '.', 'use', 'high', 'low', 'power', 'ralli', ',', 'i', 'extend', 'fib', 'level', 'outward', 'see', 'cleanli', 'set', 'support', 'resist', 'level', 'recent', 'high', 'sell', '.', 'i', 'like', 'set', 'i', 'got', 'bear', 'etf', 'like', 'sd', 'faz', 'hope', 'perman', 'resist', 'level', '1374', '.', 'right', 'look', 'like', 'may', 'push', ',', ',', 'indic', 'attempt', '1400', 'level', ',', 'make', 'sd', 'sad', '.', ':', 'p', '1400', 'interest', '.', 'not', 'psycholog', 'level', '(', 'think', 'dow', '13,000', 'stink', 'cnbc', 'make', ',', 's', '&', 'amp', ';', 'p', '1400', 'import', 's', '&', 'amp', ';', 'p', '500', 'stock', ',', '30', 'like', 'dow', ')', ',', 'also', 'next', 'fibonacci', 'level', '.', 'also', 'pay', 'attent', 'rise', 'wedg', 'sinc', 'oct', ',', 'apex', 'near', '.', 'bear', 'realli', 'much', 'go', 'except', 'potenti', 'break', 'wedg', '1340', ',', 'ever', 'come', 'first', '.', 'that', 'line', 'sand', 'technic', 'trader', '.']",[13 13  0 ...  0  0  0],5
839,3,Mark's Weekly Trading Log (3/4-3/8) Charts and Analysis,7,4,0,,"['mark', ""'s"", 'weekli', 'trade', 'log', '(', '3/4-3/8', ')', 'chart', 'analysi', 'nan']",[0 0 0 ... 0 0 0],5
200,9,Any thoughts on how the elections will affect the market?,12,3,7,Any thoughts and opinions?,"['ani', 'thought', 'elect', 'affect', 'market', '?', 'ani', 'thought', 'opinion', '?']",[0 0 0 ... 0 0 0],10
134,12,3 Warning signs about Oil prices,16,4,6,,"['3', 'warn', 'sign', 'oil', 'price', 'nan']",[0 0 0 ... 0 0 0],10
27,18,I challenge any of you experts to find fault in this analysis:,24,6,15,,"['i', 'challeng', 'expert', 'find', 'fault', 'analysi', ':', 'nan']",[0 0 0 ... 0 0 0],20
945,3,Biggest % gainers May 3rd,3,0,2,"Coming into the first hour of trading, the following stocks are showing the biggest percentage gains:

KNSY	Kensey Nash	38.35	32.20%

MGAM	Multimedia Games Holding Comp	13.75	16.92%

IO	ION Geophysical Corporation	7.32	16.19%

ELLI	Ellie Mae Inc	14.55	14.03%

LHCG	LHC Group	 19.28	12.55%

LQDT	Liquidity Services Inc	 61.67	12.27%

SYNC	SYNC	 11.19	10.92%

CNQR	Concur Technologies	64.15	10.64%

MSTR	Microstrategy Inc'A'	156.23	9.99%

WWE	World Wrestling Entr'A'	8.52	8.67%

","['biggest', '%', 'gainer', 'may', '3rd', 'come', 'first', 'hour', 'trade', ',', 'follow', 'stock', 'show', 'biggest', 'percentag', 'gain', ':', 'knsi', 'kensey', 'nash', '38.35', '32.20', '%', 'mgam', 'multimedia', 'game', 'hold', 'comp', '13.75', '16.92', '%', 'io', 'ion', 'geophys', 'corpor', '7.32', '16.19', '%', 'elli', 'elli', 'mae', 'inc', '14.55', '14.03', '%', 'lhcg', 'lhc', 'group', '19.28', '12.55', '%', 'lqdt', 'liquid', 'servic', 'inc', '61.67', '12.27', '%', 'sync', 'sync', '11.19', '10.92', '%', 'cnqr', 'concur', 'technolog', '64.15', '10.64', '%', 'mstr', 'microstrategi', 'inc', ""'"", ""a'"", '156.23', '9.99', '%', 'wwe', 'world', 'wrestl', 'entr', ""'"", ""a'"", '8.52', '8.67', '%']",[1 0 0 ... 0 0 0],5
230,6,Mark's Weekly Trading Log (2/4-2/8) Charts and Analysis,10,4,3,,"['mark', ""'s"", 'weekli', 'trade', 'log', '(', '2/4-2/8', ')', 'chart', 'analysi', 'nan']",[0 0 0 ... 0 0 0],5
489,5,Thoughts on the mortgage REIT industry?,5,0,8,"The industry has been getting killed lately due to threats of an interest rate rise. I've been following AGNC specifically that has a dividend of about 20%. Would I be attempting to catch a falling knife, or has Wall Street been overly scared off of a good value?","['thought', 'mortgag', 'reit', 'industri', '?', 'the', 'industri', 'get', 'kill', 'late', 'due', 'threat', 'interest', 'rate', 'rise', '.', 'i', ""'ve"", 'follow', 'agnc', 'specif', 'dividend', '20', '%', '.', 'would', 'i', 'attempt', 'catch', 'fall', 'knife', ',', 'wall', 'street', 'overli', 'scare', 'good', 'valu', '?']",[1 2 0 ... 0 0 0],5
772,5,Head &amp; Shoulders Forming on S&amp;P Monthly Chart,5,0,6,,"['head', '&', 'amp', ';', 'shoulder', 'form', 's', '&', 'amp', ';', 'p', 'monthli', 'chart', 'nan']",[0 0 0 ... 0 0 0],5
378,4,/SB Sugar Futures looking like a buy back up to test 17.00. Currently at 16.22,7,3,15,,"['/sb', 'sugar', 'futur', 'look', 'like', 'buy', 'back', 'test', '17.00', '.', 'current', '16.22', 'nan']",[0 1 0 ... 0 0 0],5
288,9,"How the Fed will Crash the Bond Market, and the silver lining to follow.",15,6,14,,"['how', 'fed', 'crash', 'bond', 'market', ',', 'silver', 'line', 'follow', '.', 'nan']",[1 1 0 ... 0 0 0],10
418,5,"The ETFs that have become so popular among traders, Lutz says, are “cannibalizing” the stocks that they are supposed to track – leading to choppier trading for investors in the underlying stock.",6,1,1,,"['the', 'etf', 'becom', 'popular', 'among', 'trader', ',', 'lutz', 'say', ',', '“', 'cannib', '”', 'stock', 'suppos', 'track', '–', 'lead', 'choppier', 'trade', 'investor', 'underli', 'stock', '.', 'nan']",[2 1 0 ... 0 0 0],5
674,5,"What are your favorite trading, news, and tech analysis websites?",5,0,18,"I am looking to start my own portfolio; being a finance major and all. 

Looking to have a low deposite amount of $500.


Any advice?","['what', 'favorit', 'trade', ',', 'news', ',', 'tech', 'analysi', 'websit', '?', 'i', 'look', 'start', 'portfolio', ';', 'financ', 'major', '.', 'look', 'low', 'deposit', 'amount', '$', '500', '.', 'ani', 'advic', '?']",[2 2 0 ... 0 0 0],5
391,7,Are Good Traders Born or Made?,9,2,3,,"['are', 'good', 'trader', 'born', 'made', '?', 'nan']",[0 0 0 ... 0 0 0],5
592,4,Biggest % movers May 18,6,2,0,"Looks like the hype machine managed to get some suckers into FFN which continues to pop today:

FFN	FriendFinder Networks Inc	2.03	18.77%

WGO	Winnebago Indus	10.00	17.51%

KMI.W*	Kinder Morgan Inc Wrnt W/I	1.85	12.12%

QPSA	Quepasa Corporation	4.38	12.02%

FL	Foot Locker	31.22	11.46%

CRM	salesforce.com Inc	147.58	10.30%

MFRM	Mattress Firm Holding Corp.	38.40	8.69%

NUGT	Direxion Dly Gold Miners 3X BL	9.74	8.34%

EDG	Edgen Group Inc	8.46	7.77%

ROSG(F)	Rosetta Genomics Ltd	4.25	7.59%
","['biggest', '%', 'mover', 'may', '18', 'look', 'like', 'hype', 'machin', 'manag', 'get', 'sucker', 'ffn', 'continu', 'pop', 'today', ':', 'ffn', 'friendfind', 'network', 'inc', '2.03', '18.77', '%', 'wgo', 'winnebago', 'indu', '10.00', '17.51', '%', 'kmi.w', '*', 'kinder', 'morgan', 'inc', 'wrnt', 'w/i', '1.85', '12.12', '%', 'qpsa', 'quepasa', 'corpor', '4.38', '12.02', '%', 'fl', 'foot', 'locker', '31.22', '11.46', '%', 'crm', 'salesforce.com', 'inc', '147.58', '10.30', '%', 'mfrm', 'mattress', 'firm', 'hold', 'corp.', '38.40', '8.69', '%', 'nugt', 'direxion', 'dli', 'gold', 'miner', '3x', 'bl', '9.74', '8.34', '%', 'edg', 'edgen', 'group', 'inc', '8.46', '7.77', '%', 'rosg', '(', 'f', ')', 'rosetta', 'genom', 'ltd', '4.25', '7.59', '%']",[0 0 0 ... 0 0 0],5
498,4,Mark's Weekly Trading Log (6/10-6/14) Charts Analysis and Video,8,4,2,,"['mark', ""'s"", 'weekli', 'trade', 'log', '(', '6/10-6/14', ')', 'chart', 'analysi', 'video', 'nan']",[0 0 0 ... 0 0 0],5
138,10,Motley Fool Names Cummins No. 1 Best Public Company in America,14,4,2,,"['motley', 'fool', 'name', 'cummin', 'no', '.', '1', 'best', 'public', 'compani', 'america', 'nan']",[0 1 0 ... 0 0 0],10
62,12,XOM recaptures largest market cap status,18,6,3,,"['xom', 'recaptur', 'largest', 'market', 'cap', 'statu', 'nan']",[0 0 0 ... 0 0 0],10
471,5,"GRPN reports, stock -11% after hours",6,1,8,"Groupon reported:

Groupon reports fourth-quarter loss, revenue gain
By Dan Gallagher GRPN

SAN FRANCISCO (MarketWatch) -- Groupon Inc. reported a net loss for the fourth quarter on Wednesday afternoon, surprising investors who had expected a small profit from the daily deal firm. For the period ended Dec. 31, Groupon GRPN -9.56% reported a net loss of $42.7 million, or 8 cents a share, compared to a net loss of $378.6 million, or $1.08 a share, for the same period last year. Net loss on an adjusted basis came in at $9.8 million, or 2 cents a share, for the recent period. Sales jumped 194% to $506.5 million. Analysts were expecting earnings of 3 cents a share on revenue of $473 million, according to consensus forecasts from FactSet Research.","['grpn', 'report', ',', 'stock', '-11', '%', 'hour', 'groupon', 'report', ':', 'groupon', 'report', 'fourth-quart', 'loss', ',', 'revenu', 'gain', 'by', 'dan', 'gallagh', 'grpn', 'san', 'francisco', '(', 'marketwatch', ')', '--', 'groupon', 'inc.', 'report', 'net', 'loss', 'fourth', 'quarter', 'wednesday', 'afternoon', ',', 'surpris', 'investor', 'expect', 'small', 'profit', 'daili', 'deal', 'firm', '.', 'for', 'period', 'end', 'dec.', '31', ',', 'groupon', 'grpn', '-9.56', '%', 'report', 'net', 'loss', '$', '42.7', 'million', ',', '8', 'cent', 'share', ',', 'compar', 'net', 'loss', '$', '378.6', 'million', ',', '$', '1.08', 'share', ',', 'period', 'last', 'year', '.', 'net', 'loss', 'adjust', 'basi', 'came', '$', '9.8', 'million', ',', '2', 'cent', 'share', ',', 'recent', 'period', '.', 'sale', 'jump', '194', '%', '$', '506.5', 'million', '.', 'analyst', 'expect', 'earn', '3', 'cent', 'share', 'revenu', '$', '473', 'million', ',', 'accord', 'consensu', 'forecast', 'factset', 'research', '.']",[11  5  0 ...  0  0  0],5
647,4,The optics of selling financial information,4,0,1,,"['the', 'optic', 'sell', 'financi', 'inform', 'nan']",[0 0 0 ... 0 0 0],5
128,11,"Stock looses 65% of its value in one session - $245,499,000 lost",17,6,12,,"['stock', 'loos', '65', '%', 'valu', 'one', 'session', '-', '$', '245,499,000', 'lost', 'nan']",[0 0 0 ... 0 0 0],10
971,3,"[LNKD] 10k just out, Also, more insider selling ",3,0,2,"Currently pouring over 10k, Monday is shaping up to be a great day.

link: 
http://investors.linkedin.com/sec.cfm

Edit:  After reading 10k, I see no fundamental flaws with business, however I still believe fair market value is near $10-20 per share and that it will not be able to sustain it's revenue growth rate.

Disclosure:  still short LNKD stock.","['[', 'lnkd', ']', '10k', ',', 'also', ',', 'insid', 'sell', 'current', 'pour', '10k', ',', 'monday', 'shape', 'great', 'day', '.', 'link', ':', 'http', ':', '//investors.linkedin.com/sec.cfm', 'edit', ':', 'after', 'read', '10k', ',', 'i', 'see', 'fundament', 'flaw', 'busi', ',', 'howev', 'i', 'still', 'believ', 'fair', 'market', 'valu', 'near', '$', '10-20', 'per', 'share', 'abl', 'sustain', ""'s"", 'revenu', 'growth', 'rate', '.', 'disclosur', ':', 'still', 'short', 'lnkd', 'stock', '.']",[5 3 0 ... 0 0 0],5
520,5,"30 day dividend Chasing expirement; BMO, BBE, GGE, MSFT, FF",8,3,19,"My goal is to buy stocks shortly before their ex date and then sell them. I put together a schedule for the next 30 days and left myself windows to buy and sell on any sudden price changes. My net profit is expected to be 4.65% after deducting commission. 

Some risks/concerns are that the price will drop after the dividend is awarded. I have never read of anyone doing this before but I'm sure I'm not the only one who has thought of this. 

The biggest barrier to entry is building enough capital to reduce commission costs. I'll give a report on how it goes in March.


ex dividend date|stock	    |percentage

30-JAN	       | BMO     |1.2

6-FEB  	       |BLC	    |1.1

13-FEB	       |GGE	    |1.8

19-FEB	       |MSFT	    |0.61

27-FEB	       |FF	    |0.84



I am interested in opinions.


Edit:  I tried fixing my table

Bought BMO at 63.77 on 28 Jan","['30', 'day', 'dividend', 'chase', 'expir', ';', 'bmo', ',', 'bbe', ',', 'gge', ',', 'msft', ',', 'ff', 'my', 'goal', 'buy', 'stock', 'shortli', 'ex', 'date', 'sell', '.', 'i', 'put', 'togeth', 'schedul', 'next', '30', 'day', 'left', 'window', 'buy', 'sell', 'sudden', 'price', 'chang', '.', 'my', 'net', 'profit', 'expect', '4.65', '%', 'deduct', 'commiss', '.', 'some', 'risks/concern', 'price', 'drop', 'dividend', 'award', '.', 'i', 'never', 'read', 'anyon', 'i', ""'m"", 'sure', 'i', ""'m"", 'one', 'thought', '.', 'the', 'biggest', 'barrier', 'entri', 'build', 'enough', 'capit', 'reduc', 'commiss', 'cost', '.', 'i', ""'ll"", 'give', 'report', 'goe', 'march', '.', 'ex', 'dividend', 'date|stock', '|percentag', '30-jan', '|', 'bmo', '|1.2', '6-feb', '|blc', '|1.1', '13-feb', '|gge', '|1.8', '19-feb', '|msft', '|0.61', '27-feb', '|ff', '|0.84', 'i', 'interest', 'opinion', '.', 'edit', ':', 'i', 'tri', 'fix', 'tabl', 'bought', 'bmo', '63.77', '28', 'jan']",[4 8 0 ... 0 0 0],5
838,1,No Surprises From FOMC - Statement Redline Comparison,6,5,2,,"['no', 'surpris', 'from', 'fomc', '-', 'statement', 'redlin', 'comparison', 'nan']",[0 0 0 ... 0 0 0],0
957,3,"The good leads.  Looking to start a hedge fund?  Start here with the father of hedge funds.
",3,0,0,"The man:
http://en.wikipedia.org/wiki/Alfred_Winslow_Jones

The article that started it all (PDF):
http://nakedshorts.typepad.com/files/fortune_april1966.pdf","['the', 'good', 'lead', '.', 'look', 'start', 'hedg', 'fund', '?', 'start', 'father', 'hedg', 'fund', '.', 'the', 'man', ':', 'http', ':', '//en.wikipedia.org/wiki/alfred_winslow_jon', 'the', 'articl', 'start', '(', 'pdf', ')', ':', 'http', ':', '//nakedshorts.typepad.com/files/fortune_april1966.pdf']",[0 2 0 ... 0 0 0],5
64,14,"Pressure grows for crackdown on high-frequency trading-“The liquidity that you see is not really there,”He says the new business reality that has emerged over the past five years is forcing him to do more “upstairs” trading — filling orders through privately negotiated deals ",15,1,3,,"['pressur', 'grow', 'crackdown', 'high-frequ', 'trading-', '“', 'the', 'liquid', 'see', 'realli', ',', '”', 'he', 'say', 'new', 'busi', 'realiti', 'emerg', 'past', 'five', 'year', 'forc', '“', 'upstair', '”', 'trade', '—', 'fill', 'order', 'privat', 'negoti', 'deal', 'nan']",[1 0 0 ... 0 0 0],15
812,3,Another ways to analyze moving average method?,3,0,4,"After getting details on moving averages I found that moving average is commonly used with time series data to smooth out short-term fluctuations and highlight long-term trends or cycles. So can we do technical analysis of financial data, like stock prices, returns or trading volumes before invest? What are another ways?","['anoth', 'way', 'analyz', 'move', 'averag', 'method', '?', 'after', 'get', 'detail', 'move', 'averag', 'i', 'found', 'move', 'averag', 'commonli', 'use', 'time', 'seri', 'data', 'smooth', 'short-term', 'fluctuat', 'highlight', 'long-term', 'trend', 'cycl', '.', 'so', 'technic', 'analysi', 'financi', 'data', ',', 'like', 'stock', 'price', ',', 'return', 'trade', 'volum', 'invest', '?', 'what', 'anoth', 'way', '?']",[2 1 0 ... 0 0 0],5
14,25,"The Stock Market is rigged, confirms crooks who have been caught",31,6,7,,"['the', 'stock', 'market', 'rig', ',', 'confirm', 'crook', 'caught', 'nan']",[1 0 0 ... 0 0 0],25
156,9,CHK shares smacked down,11,2,0,,"['chk', 'share', 'smack', 'nan']",[0 0 0 ... 0 0 0],10
40,16,"For Stocks, Are Record Highs Warranted?",17,1,4,,"['for', 'stock', ',', 'are', 'record', 'high', 'warrant', '?', 'nan']",[1 0 0 ... 0 0 0],15
492,5,Caught the gap up today now what about the go...,8,3,3,"The stocks I follow which I call my nifty-fifty just spent three days with 45 or more stocks on sells, and the Naz Comp declined for four consecutive days into yesterday (the only time this year), hence today's gaps across the board...

So far it's just a bounce, but if market breadth can turn positive soon (the red line dots on the **[CHART HERE](http://screencast.com/t/rwuifovmKX1)**, it'll be a go for the bulls...probably for the rest of the summer...

P.S. For a historical perspective on times when too many of the nifty-fifty on sells see the chart.

","['caught', 'gap', 'today', 'go', '...', 'the', 'stock', 'i', 'follow', 'i', 'call', 'nifty-fifti', 'spent', 'three', 'day', '45', 'stock', 'sell', ',', 'naz', 'comp', 'declin', 'four', 'consecut', 'day', 'yesterday', '(', 'time', 'year', ')', ',', 'henc', 'today', ""'s"", 'gap', 'across', 'board', '...', 'so', 'far', ""'s"", 'bounc', ',', 'market', 'breadth', 'turn', 'posit', 'soon', '(', 'red', 'line', 'dot', '*', '*', '[', 'chart', 'here', ']', '(', 'http', ':', '//screencast.com/t/rwuifovmkx1', ')', '*', '*', ',', ""'ll"", 'go', 'bull', '...', 'probabl', 'rest', 'summer', '...', 'p.', '.', 'for', 'histor', 'perspect', 'time', 'mani', 'nifty-fifti', 'sell', 'see', 'chart', '.']",[4 2 0 ... 0 0 0],5
379,6,Strongest one day rally in 6 months!,7,1,19,,"['strongest', 'one', 'day', 'ralli', '6', 'month', '!', 'nan']",[0 0 0 ... 0 0 0],5
187,10,AAPL -6% on news of margin requirements increase. ,12,2,7,"Is it time for aapl to visit this longer term support line? 

It won't be the end of the world if it does:

https://www.tradingview.com/x/urIWhE3p/","['aapl', '-6', '%', 'news', 'margin', 'requir', 'increas', '.', 'is', 'time', 'aapl', 'visit', 'longer', 'term', 'support', 'line', '?', 'it', 'wo', ""n't"", 'end', 'world', ':', 'http', ':', '//www.tradingview.com/x/uriwhe3p/']",[0 1 0 ... 0 0 0],10
763,4,EUR/GBP Setup,6,2,12,"I have been waiting for this trade for over a week now and it finally decided to play ball.

[EUR/GBP Weekend Plan - Daily](http://i.imgur.com/QDDGU.png)

Last week, price convincingly broke through the previous lows. What I am waiting for now is a retest of the 0.8222 low from beneath to give me a short setup.

[EUR/GBP Last Night - Daily](http://i.imgur.com/dzaax.png)

Here we go..

[EUR/GBP Last Night - Hourly Entry](http://i.imgur.com/JpsPh.png)

Note that it is psychologically difficult to take a short position when you see a market making such a strong move in the opposite direction. ""Standing in front of a freight train"" as it were. That is why you have to be well prepared in advance of the move so you don't bottle it.

Because I had been waiting for the position since price originally broke through the level on 18 Apr, I was confident that getting short was the correct option. I had already had days to consider the setup, should it occur. I was anticipating the market's future moves, and I knew how I would participate in the market should the move occur.

[EUR/GBP - Current Hourly](http://i.imgur.com/0oX5G.png)

Validation.

[EUR/GBP - Current Daily](http://i.imgur.com/aI6df.png)

Look at the daily candle now. It is a massive reversal candle out of resistance. My position is short from right at the tip of the candle, a very safe place to be. Well, as safe as you can get in the market.

Today, there will be thousands of other traders who will look at the daily candle and decide that it is time to go short, but I already have 40-50 pip head-start over them because I played the move at the source.","['eur/gbp', 'setup', 'i', 'wait', 'trade', 'week', 'final', 'decid', 'play', 'ball', '.', '[', 'eur/gbp', 'weekend', 'plan', '-', 'daili', ']', '(', 'http', ':', '//i.imgur.com/qddgu.png', ')', 'last', 'week', ',', 'price', 'convincingli', 'broke', 'previou', 'low', '.', 'what', 'i', 'wait', 'retest', '0.8222', 'low', 'beneath', 'give', 'short', 'setup', '.', '[', 'eur/gbp', 'last', 'night', '-', 'daili', ']', '(', 'http', ':', '//i.imgur.com/dzaax.png', ')', 'here', 'go', '..', '[', 'eur/gbp', 'last', 'night', '-', 'hourli', 'entri', ']', '(', 'http', ':', '//i.imgur.com/jpsph.png', ')', 'note', 'psycholog', 'difficult', 'take', 'short', 'posit', 'see', 'market', 'make', 'strong', 'move', 'opposit', 'direct', '.', '``', 'stand', 'front', 'freight', 'train', ""''"", '.', 'that', 'well', 'prepar', 'advanc', 'move', ""n't"", 'bottl', '.', 'becaus', 'i', 'wait', 'posit', 'sinc', 'price', 'origin', 'broke', 'level', '18', 'apr', ',', 'i', 'confid', 'get', 'short', 'correct', 'option', '.', 'i', 'alreadi', 'day', 'consid', 'setup', ',', 'occur', '.', 'i', 'anticip', 'market', ""'s"", 'futur', 'move', ',', 'i', 'knew', 'i', 'would', 'particip', 'market', 'move', 'occur', '.', '[', 'eur/gbp', '-', 'current', 'hourli', ']', '(', 'http', ':', '//i.imgur.com/0ox5g.png', ')', 'valid', '.', '[', 'eur/gbp', '-', 'current', 'daili', ']', '(', 'http', ':', '//i.imgur.com/ai6df.png', ')', 'look', 'daili', 'candl', '.', 'it', 'massiv', 'revers', 'candl', 'resist', '.', 'my', 'posit', 'short', 'right', 'tip', 'candl', ',', 'safe', 'place', '.', 'well', ',', 'safe', 'get', 'market', '.', 'today', ',', 'thousand', 'trader', 'look', 'daili', 'candl', 'decid', 'time', 'go', 'short', ',', 'i', 'alreadi', '40-50', 'pip', 'head-start', 'i', 'play', 'move', 'sourc', '.']",[ 8 15  0 ...  0  0  0],5
216,8,"Free Day Trading Chat!! Come check it today, Live scanners and Live trade Alerts all day long!!",14,6,2,"www.funkyfunds.omnovia.com

password:  TheFunk","['free', 'day', 'trade', 'chat', '!', '!', 'come', 'check', 'today', ',', 'live', 'scanner', 'live', 'trade', 'alert', 'day', 'long', '!', '!', 'www.funkyfunds.omnovia.com', 'password', ':', 'thefunk']",[1 0 0 ... 0 0 0],10
791,4,Joe Terranova takes the other side of the trade on AAPL,4,0,8,,"['joe', 'terranova', 'take', 'side', 'trade', 'aapl', 'nan']",[0 0 0 ... 0 0 0],5
52,14,ಠ_ಠ,28,14,9,,"['ಠ_ಠ', 'nan']",[0 0 0 ... 0 0 0],15
878,3,BTIG Cuts FB Rating To Sell; Sets $16 Price Target,3,0,1,,"['btig', 'cut', 'fb', 'rate', 'to', 'sell', ';', 'set', '$', '16', 'price', 'target', 'nan']",[0 0 0 ... 0 0 0],5
337,5,Europe Has Wall Street's Bull on a Short Leash,7,2,0,,"['europ', 'ha', 'wall', 'street', ""'s"", 'bull', 'short', 'leash', 'nan']",[0 0 0 ... 0 0 0],5
748,5,This looks like the wave 4 move I mentioned on Saturday,6,1,2,"On Saturday I put up a post with an Elliott wave count that was possibly unfolded.

The S&amp;P was a 1295, I suspected this was the Wave 3 bottom so I plotted a wave 4 higher which is where we seem to be right now.

If this pattern sticks, than 1340-1350 would be the ideal high before the next leg lower.

http://www.hotstockmarket.com/t/223015/stock-market-today-may-21-25#post_2862951

Wave 4's typically have some chop like we are seeing here, I would like to see some push higher from the banks to get the S&amp;P 1340 level, but going into the weekend, its anybodies game.

","['thi', 'look', 'like', 'wave', '4', 'move', 'i', 'mention', 'saturday', 'on', 'saturday', 'i', 'put', 'post', 'elliott', 'wave', 'count', 'possibl', 'unfold', '.', 'the', 's', '&', 'amp', ';', 'p', '1295', ',', 'i', 'suspect', 'wave', '3', 'bottom', 'i', 'plot', 'wave', '4', 'higher', 'seem', 'right', '.', 'if', 'pattern', 'stick', ',', '1340-1350', 'would', 'ideal', 'high', 'next', 'leg', 'lower', '.', 'http', ':', '//www.hotstockmarket.com/t/223015/stock-market-today-may-21-25', '#', 'post_2862951', 'wave', '4', ""'s"", 'typic', 'chop', 'like', 'see', ',', 'i', 'would', 'like', 'see', 'push', 'higher', 'bank', 'get', 's', '&', 'amp', ';', 'p', '1340', 'level', ',', 'go', 'weekend', ',', 'anybodi', 'game', '.']",[5 4 0 ... 0 0 0],5
719,4,"What is your bias for the second half of this year? Up, down or flat by December?",6,2,10,"What and why do you feel the market will be up, down or flat by December?

Me: Overall bearish because of Europe and expecting more companies to blame bad numbers on European exposure, but this is an election year and Obama needs the markets to move higher by November. I do not think the Fed is ready to let the market drop just yet, but that alone is not a good enough reason to be making new highs. I think we end lower than current levels unless the Fed really goes full QE3 crazy.
","['what', 'bia', 'second', 'half', 'year', '?', 'up', ',', 'flat', 'decemb', '?', 'what', 'feel', 'market', ',', 'flat', 'decemb', '?', 'me', ':', 'overal', 'bearish', 'europ', 'expect', 'compani', 'blame', 'bad', 'number', 'european', 'exposur', ',', 'elect', 'year', 'obama', 'need', 'market', 'move', 'higher', 'novemb', '.', 'i', 'think', 'fed', 'readi', 'let', 'market', 'drop', 'yet', ',', 'alon', 'good', 'enough', 'reason', 'make', 'new', 'high', '.', 'i', 'think', 'end', 'lower', 'current', 'level', 'unless', 'fed', 'realli', 'goe', 'full', 'qe3', 'crazi', '.']",[4 3 0 ... 0 0 0],5
724,2,Stock Market July 6th: top % gainers,4,2,2,"Joining the list of companies with cool ticker symbols, BOOT tops todays movers.

There are a couple of leveraged ETFs hitting the list, Semiconductor bear ETF SOXS and gold miners bear DUST making moves:

BOOT	Lacrosse Footwear	19.88	81.01%

CHTP	Chelsea Therapeutics Intl Ltd	1.21	33.22%

SYNC	SYNC	15.70	14.53%

XRTX	Xyratex Ltd	13.11	11.86%

ATRS	ATRS	4.20	9.09%

SOXS	Direxion Daily Semicon Bear 3X	40.87	7.27%

DUST	Direxion Dly Gold Miners 3X BR	46.09	6.62%

DSLV	VS 3X Inverse Silver	45.02	6.27%

ALEX	Alexander &amp; Baldwin Inc	33.05	6.07%

DTO	PowerShs DB Crude Oil Dbl Shrt	52.67	5.66%

","['stock', 'market', 'juli', '6th', ':', 'top', '%', 'gainer', 'join', 'list', 'compani', 'cool', 'ticker', 'symbol', ',', 'boot', 'top', 'today', 'mover', '.', 'there', 'coupl', 'leverag', 'etf', 'hit', 'list', ',', 'semiconductor', 'bear', 'etf', 'sox', 'gold', 'miner', 'bear', 'dust', 'make', 'move', ':', 'boot', 'lacross', 'footwear', '19.88', '81.01', '%', 'chtp', 'chelsea', 'therapeut', 'intl', 'ltd', '1.21', '33.22', '%', 'sync', 'sync', '15.70', '14.53', '%', 'xrtx', 'xyratex', 'ltd', '13.11', '11.86', '%', 'atr', 'atr', '4.20', '9.09', '%', 'sox', 'direxion', 'daili', 'semicon', 'bear', '3x', '40.87', '7.27', '%', 'dust', 'direxion', 'dli', 'gold', 'miner', '3x', 'br', '46.09', '6.62', '%', 'dslv', 'vs', '3x', 'invers', 'silver', '45.02', '6.27', '%', 'alex', 'alexand', '&', 'amp', ';', 'baldwin', 'inc', '33.05', '6.07', '%', 'dto', 'powersh', 'db', 'crude', 'oil', 'dbl', 'shrt', '52.67', '5.66', '%']",[2 1 0 ... 0 0 0],0
295,8,Market leader AAPL not leading,10,2,3,,"['market', 'leader', 'aapl', 'lead', 'nan']",[0 0 0 ... 0 0 0],10
701,3,"Home builders strong today, XHB to new 52wk highs",4,1,0,,"['home', 'builder', 'strong', 'today', ',', 'xhb', 'new', '52wk', 'high', 'nan']",[1 0 0 ... 0 0 0],5
251,7,It looks like the S&amp;P is at a 4 year high.  Justified?  Or over priced?,10,3,14,[linky](http://www.google.com/finance?q=INDEXSP:.INX),"['it', 'look', 'like', 's', '&', 'amp', ';', 'p', '4', 'year', 'high', '.', 'justifi', '?', 'or', 'price', '?', '[', 'linki', ']', '(', 'http', ':', '//www.google.com/fin', '?', 'q=indexsp', ':', '.inx', ')']",[0 1 0 ... 0 0 0],5
726,4,"This is what we call Gap n Go action. If you missed Friday's rally, now you feel like you have to chase.",6,2,10,"The markets gapped up big time on Friday, then we had the weekend to think about it and the thinking was ""I will wait for a pull back and jump in!"".

Alas, the fabled pull back did not come as Mondays levels held above the afternoon highs from Friday. 

Today we have what I like to call  the ""go"" part of the gap n go. 

All the bulls worried that they are going to miss out on the next leg of this market are diving in, taking us to 1370 on the S&amp;P at the moment.

This is very impressive action from the bulls, I really did not think we see 1370 this fast, but here we are.

I think 1400 is a stretch at this point in time, so around [1380 I have a fib resistance level](https://www.tradingview.com/x/IsHVovvX/), the risk reward here gets a bit fluffy for the bulls.

","['thi', 'call', 'gap', 'n', 'go', 'action', '.', 'if', 'miss', 'friday', ""'s"", 'ralli', ',', 'feel', 'like', 'chase', '.', 'the', 'market', 'gap', 'big', 'time', 'friday', ',', 'weekend', 'think', 'think', '``', 'i', 'wait', 'pull', 'back', 'jump', '!', ""''"", '.', 'ala', ',', 'fabl', 'pull', 'back', 'come', 'monday', 'level', 'held', 'afternoon', 'high', 'friday', '.', 'today', 'i', 'like', 'call', '``', 'go', ""''"", 'part', 'gap', 'n', 'go', '.', 'all', 'bull', 'worri', 'go', 'miss', 'next', 'leg', 'market', 'dive', ',', 'take', 'us', '1370', 's', '&', 'amp', ';', 'p', 'moment', '.', 'thi', 'impress', 'action', 'bull', ',', 'i', 'realli', 'think', 'see', '1370', 'fast', ',', '.', 'i', 'think', '1400', 'stretch', 'point', 'time', ',', 'around', '[', '1380', 'i', 'fib', 'resist', 'level', ']', '(', 'http', ':', '//www.tradingview.com/x/ishvovvx/', ')', ',', 'risk', 'reward', 'get', 'bit', 'fluffi', 'bull', '.']",[8 8 0 ... 0 0 0],5
461,6,Spanish 10yr bonds hit highest levels since Jan,8,2,3,"In our continuing coverage of ""Suddenly Spain!"", today we saw the Spanish 10yr auction hit Jan levels... not red alert levels yet, but just a sign that nothing has really changed since Jan, which should be a big shocker to absolutely nobody. :)","['spanish', '10yr', 'bond', 'hit', 'highest', 'level', 'sinc', 'jan', 'in', 'continu', 'coverag', '``', 'suddenli', 'spain', '!', '``', ',', 'today', 'saw', 'spanish', '10yr', 'auction', 'hit', 'jan', 'level', '...', 'red', 'alert', 'level', 'yet', ',', 'sign', 'noth', 'realli', 'chang', 'sinc', 'jan', ',', 'big', 'shocker', 'absolut', 'nobodi', '.', ':', ')']",[3 1 0 ... 0 0 0],5
455,7,Daytraders live chat during volatile days,10,3,5,"Hi Traders!

Big action on a lot of names today, AAPL $530 support? I sure damn hope so LOL!

During times of market volatility, a few of us are in the live chat room on HSM: http://www.hotstockmarket.com/chat/

Im in there now if anybody wants to join.
","['daytrad', 'live', 'chat', 'volatil', 'day', 'hi', 'trader', '!', 'big', 'action', 'lot', 'name', 'today', ',', 'aapl', '$', '530', 'support', '?', 'i', 'sure', 'damn', 'hope', 'lol', '!', 'dure', 'time', 'market', 'volatil', ',', 'us', 'live', 'chat', 'room', 'hsm', ':', 'http', ':', '//www.hotstockmarket.com/chat/', 'im', 'anybodi', 'want', 'join', '.']",[2 1 0 ... 0 0 0],5
991,3,SPY technical analysis for Feb 1st. Daily chart within.,3,0,0,"Some traders in the [stock market today](http://www.hotstockmarket.com/t/189855/stock-market-daily-chat-jan-30th-feb-3rd/320#post_2824473) section of the forum were mentioning the 1370 level being tossed around.

Looking at the charts I can see why they are saying that. The 1350-1370 are was resistance on the last couple of peaks, this is a natural resistance level where traders that are long will look to lighten up positions and wait to see what happens.

http://i.imgur.com/Uo66G.gif

","['spi', 'technic', 'analysi', 'feb', '1st', '.', 'daili', 'chart', 'within', '.', 'some', 'trader', '[', 'stock', 'market', 'today', ']', '(', 'http', ':', '//www.hotstockmarket.com/t/189855/stock-market-daily-chat-jan-30th-feb-3rd/320', '#', 'post_2824473', ')', 'section', 'forum', 'mention', '1370', 'level', 'toss', 'around', '.', 'look', 'chart', 'i', 'see', 'say', '.', 'the', '1350-1370', 'resist', 'last', 'coupl', 'peak', ',', 'natur', 'resist', 'level', 'trader', 'long', 'look', 'lighten', 'posit', 'wait', 'see', 'happen', '.', 'http', ':', '//i.imgur.com/uo66g.gif']",[1 5 0 ... 0 0 0],5
815,3,What do you guys think of long term gold chart?,4,1,9,,"['what', 'guy', 'think', 'long', 'term', 'gold', 'chart', '?', 'nan']",[0 0 0 ... 0 0 0],5
862,2,"Wall Street Breakfast: Must-Know News November 13, 2012",4,2,0,,"['wall', 'street', 'breakfast', ':', 'must-know', 'new', 'novemb', '13', ',', '2012', 'nan']",[1 0 0 ... 0 0 0],0
269,9,David Einhorn tells Bernanke how it is!!!!,15,6,9,,"['david', 'einhorn', 'tell', 'bernank', '!', '!', '!', '!', 'nan']",[0 0 0 ... 0 0 0],10
201,9,Yesterday WishfulTrading made a comment about picking up CMG as a dead cat bounce.  I made a snap comment about stocks dropping 20% in a day never stops there.  Turns out I was both right and wrong.,12,3,21,"I went back and did some research.  Using all S&amp;P stocks, with price &gt; $10, there had been 260 cases of 20% 1 day drop in the past 10 years.  Over the next 1, 3 and 6 months, they have moved both higher and lower.  Here are the average return(%):

    1mlow   1mhigh  1mClose 3mlow   3mhigh 1mClose 6mlow   6mhigh  1mClose
    -15.92  30.18   9.15    -26.39	44.69   9.44    -33.89  56.82   19.82

Here's the raw data if anyone is interested: http://dropcanvas.com/93sb9

One observation to make is this includes the drop caused by the Oct 2008 crash, so take it as you will.

Edit: Added close column.
","['yesterday', 'wishfultrad', 'made', 'comment', 'pick', 'cmg', 'dead', 'cat', 'bounc', '.', 'i', 'made', 'snap', 'comment', 'stock', 'drop', '20', '%', 'day', 'never', 'stop', '.', 'turn', 'i', 'right', 'wrong', '.', 'i', 'went', 'back', 'research', '.', 'use', 's', '&', 'amp', ';', 'p', 'stock', ',', 'price', '&', 'gt', ';', '$', '10', ',', '260', 'case', '20', '%', '1', 'day', 'drop', 'past', '10', 'year', '.', 'over', 'next', '1', ',', '3', '6', 'month', ',', 'move', 'higher', 'lower', '.', 'here', 'averag', 'return', '(', '%', ')', ':', '1mlow', '1mhigh', '1mclose', '3mlow', '3mhigh', '1mclose', '6mlow', '6mhigh', '1mclose', '-15.92', '30.18', '9.15', '-26.39', '44.69', '9.44', '-33.89', '56.82', '19.82', 'here', ""'s"", 'raw', 'data', 'anyon', 'interest', ':', 'http', ':', '//dropcanvas.com/93sb9', 'one', 'observ', 'make', 'includ', 'drop', 'caus', 'oct', '2008', 'crash', ',', 'take', '.', 'edit', ':', 'ad', 'close', 'column', '.']",[5 8 0 ... 0 0 0],10
161,9,Greece Deal Triggers $3B in Default Swaps,11,2,7,,"['greec', 'deal', 'trigger', '$', '3b', 'default', 'swap', 'nan']",[0 0 0 ... 0 0 0],10
555,5,Thinking of shorting Best Buy. Thoughts?,7,2,13,"I feel there is still a ways to go down yet. For their survival they must downsize so I figure as they do so should the stock price. 

I'm new to the idea I shorting so constructive criticism welcome. ","['think', 'short', 'best', 'buy', '.', 'thought', '?', 'i', 'feel', 'still', 'way', 'go', 'yet', '.', 'for', 'surviv', 'must', 'downsiz', 'i', 'figur', 'stock', 'price', '.', 'i', ""'m"", 'new', 'idea', 'i', 'short', 'construct', 'critic', 'welcom', '.']",[0 4 0 ... 0 0 0],5
729,4,SLV - closed under major support,4,0,3,"http://finviz.com/quote.ashx?t=slv

SLV closed just slightly under a major support level today, although not enough that I'd call it any sort of tradeable breakdown of support.  Anyone placing bets on either side of this?  I could argue for both a long or short position here, which of course means it's sitting on hands for me.","['slv', '-', 'close', 'major', 'support', 'http', ':', '//finviz.com/quote.ashx', '?', 't=slv', 'slv', 'close', 'slightli', 'major', 'support', 'level', 'today', ',', 'although', 'enough', 'i', ""'d"", 'call', 'sort', 'tradeabl', 'breakdown', 'support', '.', 'anyon', 'place', 'bet', 'either', 'side', '?', 'i', 'could', 'argu', 'long', 'short', 'posit', ',', 'cours', 'mean', ""'s"", 'sit', 'hand', '.']",[2 2 0 ... 0 0 0],5
401,5,Feuerstein-Ratain Rule and Shorting small-cap Biotechs,6,1,2,"With the collapse of CLSN, this 'rule' has gained some attention again on the internet.  Basically the idea is that you are better off shorting Biotechs in the oncology market before phase III results if their market cap is &lt; 300M.  Going long is only a good idea for bios with market cap &gt; 1B.  

To summarize the Feuerstein-Ratain results, they found that 21 of the 21 analyzed low-cap oncology biotechs lost share price after publishing phase III results.  21 of the 27 big-cap oncology bios did ok after phase III results.

Has anyone played around with this short/long strategy?  

Links for context:
http://www.fool.com/investing/general/2013/01/18/will-the-feuerstein-ratain-rule-hold-in.aspx
http://jnci.oxfordjournals.org/content/early/2011/09/26/jnci.djr375.full
","['feuerstein-ratain', 'rule', 'short', 'small-cap', 'biotech', 'with', 'collaps', 'clsn', ',', ""'rule"", ""'"", 'gain', 'attent', 'internet', '.', 'basic', 'idea', 'better', 'short', 'biotech', 'oncolog', 'market', 'phase', 'iii', 'result', 'market', 'cap', '&', 'lt', ';', '300m', '.', 'go', 'long', 'good', 'idea', 'bio', 'market', 'cap', '&', 'gt', ';', '1b', '.', 'to', 'summar', 'feuerstein-ratain', 'result', ',', 'found', '21', '21', 'analyz', 'low-cap', 'oncolog', 'biotech', 'lost', 'share', 'price', 'publish', 'phase', 'iii', 'result', '.', '21', '27', 'big-cap', 'oncolog', 'bio', 'ok', 'phase', 'iii', 'result', '.', 'ha', 'anyon', 'play', 'around', 'short/long', 'strategi', '?', 'link', 'context', ':', 'http', ':', '//www.fool.com/investing/general/2013/01/18/will-the-feuerstein-ratain-rule-hold-in.aspx', 'http', ':', '//jnci.oxfordjournals.org/content/early/2011/09/26/jnci.djr375.ful']",[2 5 0 ... 0 0 0],5
702,5,KCG- someone wants the fuck out,6,1,10,estimating pre-tax losses of 440 mil for kcg,"['kcg-', 'someon', 'want', 'fuck', 'estim', 'pre-tax', 'loss', '440', 'mil', 'kcg']",[0 0 0 ... 0 0 0],5
476,4,"I've never traded stocks in my life, I would like to buy shares in a particular company. Where do I start? (Based in the UK)",6,2,11,,"['i', ""'ve"", 'never', 'trade', 'stock', 'life', ',', 'i', 'would', 'like', 'buy', 'share', 'particular', 'compani', '.', 'where', 'i', 'start', '?', '(', 'base', 'uk', ')', 'nan']",[1 1 0 ... 0 0 0],5
821,3,Any futures traders in here?,3,0,7,What's your favorite instruments? ,"['ani', 'futur', 'trader', '?', 'what', ""'s"", 'favorit', 'instrument', '?']",[0 0 0 ... 0 0 0],5
771,3,GRPN - closes -16.89%; settles class action lawsuit for 8.5 million,4,1,7,"&gt;GRPN agreed to pay $8.5 million to settle a class-action lawsuit alleging the expiration dates on its coupons are illegal.

[Source](http://www.bloomberg.com/news/2012-04-02/groupon-to-settle-class-action-lawsuit-for-8-5-million-1-.html)

From an earlier article and analysis on GRPN before it went public:
&gt; The products may be subject to federal laws including the Credit Card Accountability Responsibility and Disclosure Act of 2009 (CARD Act), which may affect their stated expiration date, for example. (Maybe that’s why the company sends out e-mails reminding you to use your Groupons.) The company also has encountered unexpected state regulations, such as a notification from the state of Massachusetts that some restaurant discounts in that state might violate liquor laws. The company also mentioned potential regulation in Europe, which has laws governing “electronic money institutions.”


Excuse me while I go throw some chairs.

EDIT: More research posted on the history of this issue. Moving on to the destruction of car windows.","['grpn', '-', 'close', '-16.89', '%', ';', 'settl', 'class', 'action', 'lawsuit', '8.5', 'million', '&', 'gt', ';', 'grpn', 'agre', 'pay', '$', '8.5', 'million', 'settl', 'class-act', 'lawsuit', 'alleg', 'expir', 'date', 'coupon', 'illeg', '.', '[', 'sourc', ']', '(', 'http', ':', '//www.bloomberg.com/news/2012-04-02/groupon-to-settle-class-action-lawsuit-for-8-5-million-1-.html', ')', 'from', 'earlier', 'articl', 'analysi', 'grpn', 'went', 'public', ':', '&', 'gt', ';', 'the', 'product', 'may', 'subject', 'feder', 'law', 'includ', 'credit', 'card', 'account', 'respons', 'disclosur', 'act', '2009', '(', 'card', 'act', ')', ',', 'may', 'affect', 'state', 'expir', 'date', ',', 'exampl', '.', '(', 'mayb', '’', 'compani', 'send', 'e-mail', 'remind', 'use', 'groupon', '.', ')', 'the', 'compani', 'also', 'encount', 'unexpect', 'state', 'regul', ',', 'notif', 'state', 'massachusett', 'restaur', 'discount', 'state', 'might', 'violat', 'liquor', 'law', '.', 'the', 'compani', 'also', 'mention', 'potenti', 'regul', 'europ', ',', 'law', 'govern', '“', 'electron', 'money', 'institutions.', '”', 'excus', 'i', 'go', 'throw', 'chair', '.', 'edit', ':', 'more', 'research', 'post', 'histori', 'issu', '.', 'move', 'destruct', 'car', 'window', '.']",[4 7 0 ... 0 0 0],5
105,12,low volume doldrums,23,11,8,,"['low', 'volum', 'doldrum', 'nan']",[0 0 0 ... 0 0 0],10
565,6,Weekly Recap,7,1,0,,"['weekli', 'recap', 'nan']",[0 0 0 ... 0 0 0],5
389,4,Mark's Weekly Trading Log (4/22-4/26) Charts and Analysis,9,5,0,,"['mark', ""'s"", 'weekli', 'trade', 'log', '(', '4/22-4/26', ')', 'chart', 'analysi', 'nan']",[0 0 0 ... 0 0 0],5
1,40,"Bitcoin got slammed today, chart of the day:",53,13,19,,"['bitcoin', 'got', 'slam', 'today', ',', 'chart', 'day', ':', 'nan']",[1 0 0 ... 0 0 0],40
932,3,S&amp;P coming up on the first batch of resistance levels,4,1,4,,"['s', '&', 'amp', ';', 'p', 'come', 'first', 'batch', 'resist', 'level', 'nan']",[0 0 0 ... 0 0 0],5
977,3,Here we go! Dow 20k target by next year. Seriously!,4,1,5,,"['here', 'go', '!', 'dow', '20k', 'target', 'next', 'year', '.', 'serious', '!', 'nan']",[0 1 0 ... 0 0 0],5
561,5,KCG-Who's Holding Their Trades through the Weekend?,5,0,12,"Long or short.  Lets hear it.  
Closed mine.  Want to have a good weekend.  :)","['kcg-who', ""'s"", 'hold', 'their', 'trade', 'weekend', '?', 'long', 'short', '.', 'let', 'hear', '.', 'close', 'mine', '.', 'want', 'good', 'weekend', '.', ':', ')']",[0 4 0 ... 0 0 0],5
80,11,"What is your favourite site regarding finance (stocks, options, real estate...)?",15,4,12,So far mine is Yahoo! Finance. Anything better/different out there?,"['what', 'favourit', 'site', 'regard', 'financ', '(', 'stock', ',', 'option', ',', 'real', 'estat', '...', ')', '?', 'so', 'far', 'mine', 'yahoo', '!', 'financ', '.', 'anyth', 'better/differ', '?']",[2 1 0 ... 0 0 0],10
205,7,[Update] Let them eat CAKE!,17,10,5,,"['[', 'updat', ']', 'let', 'eat', 'cake', '!', 'nan']",[0 0 0 ... 0 0 0],5
34,18,"FB -8% today, somebody decided to dump it.",19,1,8,,"['fb', '-8', '%', 'today', ',', 'somebodi', 'decid', 'dump', '.', 'nan']",[1 1 0 ... 0 0 0],20
775,5,Why Shouldn't I Buy CVX Here?,5,0,9,,"['whi', 'should', ""n't"", 'i', 'buy', 'cvx', 'here', '?', 'nan']",[0 0 0 ... 0 0 0],5
508,4,"SPX 1600 or bust!... If you're a bear, then just bust.",5,1,6,I've been baffled by this up move since November.  What the heck is going on?,"['spx', '1600', 'bust', '!', '...', 'if', ""'re"", 'bear', ',', 'bust', '.', 'i', ""'ve"", 'baffl', 'move', 'sinc', 'novemb', '.', 'what', 'heck', 'go', '?']",[1 2 0 ... 0 0 0],5
427,5,Mark's Weekly Trading Log Updated.,6,1,5,"Link.
http://www.hotstockmarket.com/t/166656/marks-trading-log/60#post_2886681","['mark', ""'s"", 'weekli', 'trade', 'log', 'updat', '.', 'link', '.', 'http', ':', '//www.hotstockmarket.com/t/166656/marks-trading-log/60', '#', 'post_2886681']",[0 2 0 ... 0 0 0],5
454,7,Fed Watch: Is QE3 Just Around the Corner?,11,4,1,,"['fed', 'watch', ':', 'is', 'qe3', 'just', 'around', 'corner', '?', 'nan']",[0 0 0 ... 0 0 0],5
366,6,IchiFutures S&amp;P Daytrade 7/30,12,6,4,,"['ichifutur', 's', '&', 'amp', ';', 'p', 'daytrad', '7/30', 'nan']",[0 0 0 ... 0 0 0],5
91,11,AAPL macd-H double bottom divergence,13,2,11,"I wanted a piece of AAPL for a long time and waited for the right time. Today I saw it come up on one of the scans I run daily and took a look at the chart.
The weekly chart looks almost like a double bottom from April's low to today and the MACD-H which was slightly negative at April is now slightly positive.

http://stockcharts.com/h-sc/ui?s=AAPL&amp;p=W&amp;b=5&amp;g=0&amp;id=p98481893927 

I bought the deep in the money far out in the future mini call with strike of 330 and expiration on Jan 2015 for 92.40 each.

I plan on waiting for it to rise and sell covered calls out of the money for income in the coming months.

Also AAPL is on the MagicFormulaInvesting.com list and passes the Rule#1 criteria so it is a high probability good stock for the coming years.

I like to combine strong justifications from an investor's point of view with the trader's point of view. I hope I didn't massage the data too much to fit what I wanted to see.

What do you think? Was I reckless?","['aapl', 'macd-h', 'doubl', 'bottom', 'diverg', 'i', 'want', 'piec', 'aapl', 'long', 'time', 'wait', 'right', 'time', '.', 'today', 'i', 'saw', 'come', 'one', 'scan', 'i', 'run', 'daili', 'took', 'look', 'chart', '.', 'the', 'weekli', 'chart', 'look', 'almost', 'like', 'doubl', 'bottom', 'april', ""'s"", 'low', 'today', 'macd-h', 'slightli', 'neg', 'april', 'slightli', 'posit', '.', 'http', ':', '//stockcharts.com/h-sc/ui', '?', 's=aapl', '&', 'amp', ';', 'p=w', '&', 'amp', ';', 'b=5', '&', 'amp', ';', 'g=0', '&', 'amp', ';', 'id=p98481893927', 'i', 'bought', 'deep', 'money', 'far', 'futur', 'mini', 'call', 'strike', '330', 'expir', 'jan', '2015', '92.40', '.', 'i', 'plan', 'wait', 'rise', 'sell', 'cover', 'call', 'money', 'incom', 'come', 'month', '.', 'also', 'aapl', 'magicformulainvesting.com', 'list', 'pass', 'rule', '#', '1', 'criteria', 'high', 'probabl', 'good', 'stock', 'come', 'year', '.', 'i', 'like', 'combin', 'strong', 'justif', 'investor', ""'s"", 'point', 'view', 'trader', ""'s"", 'point', 'view', '.', 'i', 'hope', 'i', ""n't"", 'massag', 'data', 'much', 'fit', 'i', 'want', 'see', '.', 'what', 'think', '?', 'wa', 'i', 'reckless', '?']",[0 8 0 ... 0 0 0],10
339,6,Facebook IPO: Shareholders Look To Cash Out,8,2,2,,"['facebook', 'ipo', ':', 'sharehold', 'look', 'to', 'cash', 'out', 'nan']",[0 0 0 ... 0 0 0],5
897,3,chart of negative earnings surprises… and the dates and remember what happened following this negative data….,3,0,1,,"['chart', 'neg', 'earn', 'surprises…', 'date', 'rememb', 'happen', 'follow', 'neg', 'data…', '.', 'nan']",[0 1 0 ... 0 0 0],5
564,4,"This is what happens when you rely on business ""reporting""",5,1,6,"This morning, before the New Home Sales report due at 10AM, on Bloomberg's front page:

http://www.bloomberg.com/news/2012-07-25/purchases-of-new-u-s-homes-probably-climbed-to-two-year-high.html

Notice that the numbers are all ""economists project"" and ""according to the median forecast of 371,000"".  SPX was around +0.3%

10AM rolls around and the data comes out:


BREAKING NEWS
Sales of New U.S. Homes Unexpectedly Fall from Two-Year High
U.S. JUNE NEW-HOME SALES DROP 8.4% TO 350,000 ANNUAL RATE

SPX now -0.12%

This is why it's always good to see the data and ignore projections, estimates, expectations, talking heads, and other fluff....","['thi', 'happen', 'reli', 'busi', '``', 'report', ""''"", 'thi', 'morn', ',', 'new', 'home', 'sale', 'report', 'due', '10am', ',', 'bloomberg', ""'s"", 'front', 'page', ':', 'http', ':', '//www.bloomberg.com/news/2012-07-25/purchases-of-new-u-s-homes-probably-climbed-to-two-year-high.html', 'notic', 'number', '``', 'economist', 'project', ""''"", '``', 'accord', 'median', 'forecast', '371,000', ""''"", '.', 'spx', 'around', '+0.3', '%', '10am', 'roll', 'around', 'data', 'come', ':', 'break', 'new', 'sale', 'new', 'u.s.', 'home', 'unexpectedli', 'fall', 'two-year', 'high', 'u.s.', 'june', 'new-hom', 'sale', 'drop', '8.4', '%', 'to', '350,000', 'annual', 'rate', 'spx', '-0.12', '%', 'thi', ""'s"", 'alway', 'good', 'see', 'data', 'ignor', 'project', ',', 'estim', ',', 'expect', ',', 'talk', 'head', ',', 'fluff', '....']",[6 1 0 ... 0 0 0],5
345,7,GMCR -40% and getting uglier,8,1,7,"What an amazing story this stock has had over the past year.

From the amazing run to $110  last summer, they looked unstoppable! Everybody needs to keep buying those k-cups, once you are hooked, you are hooked!

Today it looks like an open below $30.

http://finviz.com/chart.ashx?t=GMCR&amp;ty=c&amp;ta=1&amp;p=d&amp;s=l","['gmcr', '-40', '%', 'get', 'uglier', 'what', 'amaz', 'stori', 'stock', 'past', 'year', '.', 'from', 'amaz', 'run', '$', '110', 'last', 'summer', ',', 'look', 'unstopp', '!', 'everybodi', 'need', 'keep', 'buy', 'k-cup', ',', 'hook', ',', 'hook', '!', 'today', 'look', 'like', 'open', '$', '30', '.', 'http', ':', '//finviz.com/chart.ashx', '?', 't=gmcr', '&', 'amp', ';', 'ty=c', '&', 'amp', ';', 'ta=1', '&', 'amp', ';', 'p=d', '&', 'amp', ';', 's=l']",[3 2 0 ... 0 0 0],5
776,4,Will CHK verify a breakout this week?,4,0,6,,"['will', 'chk', 'verifi', 'breakout', 'week', '?', 'nan']",[0 0 0 ... 0 0 0],5
241,7,"Wheee! Nice big bounce today, I hope some of you got to play it!",9,2,16,"I posted that chart last week that was calling for a rally sooner than later, thank goodness it worked out! lol

I had a 1351 long from Friday, I closed it up today at 1380. I think we may get a little more upside, but Im interested in playing a short term leg down next.

Anybody here lucky enough to get some of that AAPL $505 area?","['wheee', '!', 'nice', 'big', 'bounc', 'today', ',', 'i', 'hope', 'got', 'play', '!', 'i', 'post', 'chart', 'last', 'week', 'call', 'ralli', 'sooner', 'later', ',', 'thank', 'good', 'work', '!', 'lol', 'i', '1351', 'long', 'friday', ',', 'i', 'close', 'today', '1380', '.', 'i', 'think', 'may', 'get', 'littl', 'upsid', ',', 'im', 'interest', 'play', 'short', 'term', 'leg', 'next', '.', 'anybodi', 'lucki', 'enough', 'get', 'aapl', '$', '505', 'area', '?']",[4 2 0 ... 0 0 0],5
13,26,"""I ain't losing shit"" - Craziest trading I've ever seen (S&amp;P Futures)",29,3,26,,"['``', 'i', 'ai', ""n't"", 'lose', 'shit', ""''"", '-', 'craziest', 'trade', 'i', ""'ve"", 'ever', 'seen', '(', 's', '&', 'amp', ';', 'p', 'futur', ')', 'nan']",[0 0 0 ... 0 0 0],25
315,9,"Thoughts?  If AAPL does release an iPad Mini, is that lights out for Kindle Fire?",11,2,18,"Just a thought, AAPL is moving up on rumors of iPhone 5, iPad, and iPad mini, if that's true, wouldn't you think AMZN, makes of the Kindle and Kindle Fire, are poised to go down on the news?  

With AMZN moving up, I'm wondering if now is a good time for some Sept 22 puts?","['thought', '?', 'if', 'aapl', 'releas', 'ipad', 'mini', ',', 'light', 'kindl', 'fire', '?', 'just', 'thought', ',', 'aapl', 'move', 'rumor', 'iphon', '5', ',', 'ipad', ',', 'ipad', 'mini', ',', ""'s"", 'true', ',', 'would', ""n't"", 'think', 'amzn', ',', 'make', 'kindl', 'kindl', 'fire', ',', 'pois', 'go', 'news', '?', 'with', 'amzn', 'move', ',', 'i', ""'m"", 'wonder', 'good', 'time', 'sept', '22', 'put', '?']",[9 0 0 ... 0 0 0],10
600,5,EURUSD short 1.32andchange,6,1,13,"Im trying to catch some downside in the EURUSD here, shorted some 1.3218, giving it some wiggle room to 1.3250, and now that I said that area is my stop, it is guaranteed to go there, so I will give it more wiggle room if needed lol


","['eurusd', 'short', '1.32andchang', 'im', 'tri', 'catch', 'downsid', 'eurusd', ',', 'short', '1.3218', ',', 'give', 'wiggl', 'room', '1.3250', ',', 'i', 'said', 'area', 'stop', ',', 'guarante', 'go', ',', 'i', 'give', 'wiggl', 'room', 'need', 'lol']",[5 0 0 ... 0 0 0],5
387,8,"LNKD -10%, going the opposite direction today.",10,2,1,"By Benjamin Pimentel

SAN FRANCISCO (MarketWatch) — LinkedIn Corp. may have spooked investors on Friday with a disappointing outlook, but Wall Street remained relatively positive on the professional social network, with many brokers raising their estimates for the company.

Several also pumped up their price targets on the stock — which had soared more than 60% over the last three months until LinkedIn reported first-quarter results on Thursday afternoon. Many analysts paint the lower forecast as a hiccup due to a change in the company’s marketing services business and management conservatism.

LinkedIn  shares were down 9% at $183.34 in early trades on Friday. The stock had set a new all-time high — crossing the $200 mark — on Thursday prior to its first-quarter report. ","['lnkd', '-10', '%', ',', 'go', 'opposit', 'direct', 'today', '.', 'by', 'benjamin', 'pimentel', 'san', 'francisco', '(', 'marketwatch', ')', '—', 'linkedin', 'corp.', 'may', 'spook', 'investor', 'friday', 'disappoint', 'outlook', ',', 'wall', 'street', 'remain', 'rel', 'posit', 'profession', 'social', 'network', ',', 'mani', 'broker', 'rais', 'estim', 'compani', '.', 'sever', 'also', 'pump', 'price', 'target', 'stock', '—', 'soar', '60', '%', 'last', 'three', 'month', 'linkedin', 'report', 'first-quart', 'result', 'thursday', 'afternoon', '.', 'mani', 'analyst', 'paint', 'lower', 'forecast', 'hiccup', 'due', 'chang', 'compani', '’', 'market', 'servic', 'busi', 'manag', 'conservat', '.', 'linkedin', 'share', '9', '%', '$', '183.34', 'earli', 'trade', 'friday', '.', 'the', 'stock', 'set', 'new', 'all-tim', 'high', '—', 'cross', '$', '200', 'mark', '—', 'thursday', 'prior', 'first-quart', 'report', '.']",[3 6 0 ... 0 0 0],10
273,9,Hello 1400!,9,0,7,"Yesterday there was some analyst with a 1430 EOY target, at this rate, it will happen on Monday :P
","['hello', '1400', '!', 'yesterday', 'analyst', '1430', 'eoy', 'target', ',', 'rate', ',', 'happen', 'monday', ':', 'p']",[2 0 0 ... 0 0 0],10
166,7,"CAT earnings tomorrow. Solid support at $80, but also...",9,2,17,,"['cat', 'earn', 'tomorrow', '.', 'solid', 'support', '$', '80', ',', 'also', '...', 'nan']",[1 1 0 ... 0 0 0],5
840,2,Don't be fooled: 7.7% is likely a short-lived low in the US unemployment rate,6,4,1,,"['do', ""n't"", 'fool', ':', '7.7', '%', 'like', 'short-liv', 'low', 'us', 'unemploy', 'rate', 'nan']",[0 0 0 ... 0 0 0],0
987,3,FEb 8th morning movers,5,2,0,"Some recognizable names making moves right out the gate:

SANW	S&amp;W Seed Company	6.10	32.61%

CSC	Computer Sciences	32.62	23.19%

AVID	Avid Technology	11.98	20.04%

CALX	Calix Networks Inc	10.19	18.63%

BWLD	Buffalo Wild Wings	79.59	13.39%

RL	Ralph Lauren Corp.	174.47	11.08%

SMSI	Smith Micro Software	2.73	9.20%

HCSG	Healthcare Svcs Group	20.73	9.11%

FCEL	Fuelcell Energy	1.22	8.79%

RMBS	Rambus Inc	8.19	8.48%

BVSN	BroadVision Inc	35.30	8.28%


RL - Ralph Lauren up to new highs on strong Q3 earnings. ANF and others possibly getting some sympathy buyers.
","['feb', '8th', 'morn', 'mover', 'some', 'recogniz', 'name', 'make', 'move', 'right', 'gate', ':', 'sanw', 's', '&', 'amp', ';', 'w', 'seed', 'compani', '6.10', '32.61', '%', 'csc', 'comput', 'scienc', '32.62', '23.19', '%', 'avid', 'avid', 'technolog', '11.98', '20.04', '%', 'calx', 'calix', 'network', 'inc', '10.19', '18.63', '%', 'bwld', 'buffalo', 'wild', 'wing', '79.59', '13.39', '%', 'rl', 'ralph', 'lauren', 'corp.', '174.47', '11.08', '%', 'smsi', 'smith', 'micro', 'softwar', '2.73', '9.20', '%', 'hcsg', 'healthcar', 'svc', 'group', '20.73', '9.11', '%', 'fcel', 'fuelcel', 'energi', '1.22', '8.79', '%', 'rmb', 'rambu', 'inc', '8.19', '8.48', '%', 'bvsn', 'broadvis', 'inc', '35.30', '8.28', '%', 'rl', '-', 'ralph', 'lauren', 'new', 'high', 'strong', 'q3', 'earn', '.', 'anf', 'other', 'possibl', 'get', 'sympathi', 'buyer', '.']",[0 2 0 ... 0 0 0],5
646,5,Will VIX give us a push below 14 as a good signal for the bears?,5,0,11,,"['will', 'vix', 'give', 'us', 'push', '14', 'good', 'signal', 'bear', '?', 'nan']",[0 0 0 ... 0 0 0],5
818,3,What is this NDLS? Have you ever eaten at one? +50% so far.,3,0,11,,"['what', 'ndl', '?', 'have', 'ever', 'eaten', 'one', '?', '+50', '%', 'far', '.', 'nan']",[0 1 0 ... 0 0 0],5
484,7,Anybody trading oil? What are the chances of a pullback to 103?,10,3,18,,"['anybodi', 'trade', 'oil', '?', 'what', 'chanc', 'pullback', '103', '?', 'nan']",[0 0 0 ... 0 0 0],5
975,2,Apple Decouples From Stock Market Gravity,4,2,4,,"['appl', 'decoupl', 'from', 'stock', 'market', 'graviti', 'nan']",[0 0 0 ... 0 0 0],0
504,5,Consumer Confidence in US Rose More Than Forecast in April,6,1,1,,"['consum', 'confid', 'us', 'rose', 'more', 'than', 'forecast', 'april', 'nan']",[0 0 0 ... 0 0 0],5
831,4,"Long GS, FCX, AAPL and short GILD, PFE and SPG tomorrow.",7,3,3,Buying ATM calls and puts on the underlying.,"['long', 'gs', ',', 'fcx', ',', 'aapl', 'short', 'gild', ',', 'pfe', 'spg', 'tomorrow', '.', 'buy', 'atm', 'call', 'put', 'underli', '.']",[3 2 0 ... 0 0 0],5
243,7,"The market is now below where it was when QE Infinity was announced.
",8,1,2,"Both on the daily and weekly S&amp;P chart.

Looks like the magic is used up.  Does uncle Ben have any more tricks up his sleeve?  Next FOMC meeting is Oct 23-24.
","['the', 'market', 'qe', 'infin', 'announc', '.', 'both', 'daili', 'weekli', 's', '&', 'amp', ';', 'p', 'chart', '.', 'look', 'like', 'magic', 'use', '.', 'doe', 'uncl', 'ben', 'trick', 'sleev', '?', 'next', 'fomc', 'meet', 'oct', '23-24', '.']",[0 4 0 ... 0 0 0],5
566,6,Mark's Trading Log Updated!,6,0,14,"My weekly compilation of charts and analysis.

http://www.hotstockmarket.com/t/166656/marks-trading-log/60#post_2878727","['mark', ""'s"", 'trade', 'log', 'updat', '!', 'my', 'weekli', 'compil', 'chart', 'analysi', '.', 'http', ':', '//www.hotstockmarket.com/t/166656/marks-trading-log/60', '#', 'post_2878727']",[0 1 0 ... 0 0 0],5
875,1,Tokushima Worldwide - Shell in Alaska.,7,6,0,,"['tokushima', 'worldwid', '-', 'shell', 'alaska', '.', 'nan']",[0 1 0 ... 0 0 0],0
562,5,Mark's Weekly Trading Log Updated!,6,1,2,http://www.hotstockmarket.com/t/166656/marks-trading-log/60#post_2880385,"['mark', ""'s"", 'weekli', 'trade', 'log', 'updat', '!', 'http', ':', '//www.hotstockmarket.com/t/166656/marks-trading-log/60', '#', 'post_2880385']",[0 0 0 ... 0 0 0],5
686,5,Next Week’s Tape: Earnings Season Kicks Off,5,0,0,,"['next', 'week', '’', 'tape', ':', 'earn', 'season', 'kick', 'off', 'nan']",[0 0 0 ... 0 0 0],5
189,9,"AAPL still below the trendline, Im waiting to see this taken out",12,3,7,,"['aapl', 'still', 'trendlin', ',', 'im', 'wait', 'see', 'taken', 'nan']",[1 0 0 ... 0 0 0],10
782,4,"Bounce target hit, now to see if there is follow through to the downside",5,1,3,,"['bounc', 'target', 'hit', ',', 'see', 'follow', 'downsid', 'nan']",[1 0 0 ... 0 0 0],5
699,3,Motorola mobility cuts 20% of their employees. What's the play tomorrow? ,4,1,4,,"['motorola', 'mobil', 'cut', '20', '%', 'employe', '.', 'what', ""'s"", 'play', 'tomorrow', '?', 'nan']",[0 1 0 ... 0 0 0],5
475,6,Euro falls to 1.27 on mediocre Italian debt sales,6,0,1,,"['euro', 'fall', '1.27', 'mediocr', 'italian', 'debt', 'sale', 'nan']",[0 0 0 ... 0 0 0],5
681,5,"We are back! Reddit was down for most of the day, problems at AMZN's cloud.",8,3,3,"Coincidence?

-2.5% on AMZN today :P

http://finviz.com/chart.ashx?t=AMZN&amp;ty=c&amp;ta=1&amp;p=d&amp;s=l","['we', 'back', '!', 'reddit', 'day', ',', 'problem', 'amzn', ""'s"", 'cloud', '.', 'coincid', '?', '-2.5', '%', 'amzn', 'today', ':', 'p', 'http', ':', '//finviz.com/chart.ashx', '?', 't=amzn', '&', 'amp', ';', 'ty=c', '&', 'amp', ';', 'ta=1', '&', 'amp', ';', 'p=d', '&', 'amp', ';', 's=l']",[1 1 0 ... 0 0 0],5
510,4,Mark's Weekly Trading Log (3/25-3/29) Charts and Analysis--Special Month/Quarter Ending Edition,7,3,1,,"['mark', ""'s"", 'weekli', 'trade', 'log', '(', '3/25-3/29', ')', 'chart', 'analysi', '--', 'special', 'month/quart', 'end', 'edit', 'nan']",[0 0 0 ... 0 0 0],5
58,14,"Latest trend to make your stock rally, fire your CEO!",15,1,1,,"['latest', 'trend', 'make', 'stock', 'ralli', ',', 'fire', 'ceo', '!', 'nan']",[1 0 0 ... 0 0 0],15
474,7,AAPL releases list of its suppliers,7,0,0,"Most of these companies are known to be Apple suppliers, but a few may be new names. Usually when a previously unknown company comes out as a supplier, they see a big move in their stock if they are public.

Apple Suppliers 2011


AAC Technologies Holdings Inc.

AcBel Polytech Inc.

Acument Global Technologies

Advanced Micro Devices, Inc.

Amperex Technology Ltd.

Amphenol Corporation
Analog Devices, Inc.

Anjie Insulating Material Co., Ltd.

Asahi Kasei Corporation

AU Optronics Corporation

Austria Technologie &amp; Systemtechnik

AG austriamicrosystems

Avago Technologies Ltd.

Brady Corporation

Brilliant International Group Ltd.

Broadcom Corporation

Broadway Industrial Group Ltd.

ByD Company Ltd.

Career Technology (MFG.)

Catcher Technology Co., Ltd.

Cheng Loong Corporation

Cheng Uei Precision Industry Co., Ltd.

(Foxlink) Chimei Innolux Corporation

Coilcraft, Inc.

Compeq Manufacturing Co., Ltd.

Cosmosupplylab Ltd.

CymMetrik (Shenzhen)Printing Co

Cyntec Co., Ltd.

Cypress Semiconductor Corporation

Daishinku Corporation (KDS)

Darfon Electronics Corporation

Delta Electronics Inc.

Diodes Inc.
Dynapack International Technology

Elpida Memory, Inc.

Emerson Electric Co.

ES Power Co., Ltd.
Fairchild Semiconductor

International Fastening Technology Pte Ltd.

FLEXium Interconnect, Inc.

Flextronics International Ltd.
Fortune Grand Enterprise Co., Ltd.

Foster Electric Co., Ltd.

Fuji Crystal Manufactory Ltd.

Fujikura Ltd.
Grand Upright Technology Ltd.

Gruppo Dani S.p.A.

Gruppo Peretti

Hama Naka Shoukin Industry Co., Ltd.

Hanson Metal Factory Ltd.
Heptagon Advanced Micro-Optics Pte Ltd.

Hi-P International Ltd.

Hitachi-LG Data Storage

Hon Hai Precision Industry Co., Ltd. (Foxconn)

Hynix Semiconductor Inc.

Ibiden Co., Ltd.

Infineon Technologies

AG Intel Corporation
Interflex Co., Ltd.

International Rectifier Corporation

Intersil Corporation

Inventec Appliances Corporation

Jabil Circuit, Inc.

Japan Aviation Electronics Industry, Ltd.

Jin Li Mould Manufacturing Pte Ltd.

Kaily Packaging Pte Ltd.

Kenseisha Sdn. Bhd.

Knowles Electronics

Kunshan

Changyun Electronic Industry

Laird Technologies

Lateral Solutions Pte Ltd.

Lens One Technology (Shenzhen) Co., Ltd.

LG Chem, Ltd.

LG Display Co., Ltd.

LG Innotek Co., Ltd.

Linear Technology Corporation

Lite-On Technology Corporation

Longwell Company

LSI Corporation

Luen Fung Commercial Holdings Ltd.

Macronix International Co., Ltd.

Marian, Inc.

Marvell Technology Group Ltd.

Maxim Integrated Products, Inc.

Meiko Electronics Co., Ltd.

Microchip Technology Inc.

Micron Technology, Inc.

Mitsumi Electric Co., Ltd.

Molex Inc.

Multek Corporation

Multi-Fineline Electronix, Inc.

Murata Manufacturing Co., Ltd.

Nan ya Printed Circuit Board Corporation

NEC Corporation

Nippon Mektron, Ltd.

Nishoku Technology Inc.

NVIDIA Corporation

NXP Semiconductor N.V.

ON Semiconductor Corporation

Optrex Corporation

Oriental Printed Circuits Ltd.

Panasonic Corporation

PCH International

Pegatron Corporation

Pioneer Material Precision Tech

Prent Corporation

Primax Electronics Ltd.

Qualcomm Incorporated

Quanta Computer Inc.

Renesas Electronics Corporation

Ri-Teng Computer Accessory Co., Ltd.

ROHM Co., Ltd.

Rubycon Corporation

Samsung Electro-Mechanics Co., Ltd.

Samsung Electronics Co., Ltd.

SanDisk Corporation

SANYO Electric Co., Ltd.

SDI Corporation

Seagate Technologies

Seiko Epson Corporation

Seiko Group
Sharp Corporation

Shimano Inc.

Shin Zu Shing Co., Ltd.

Silego Technology Inc.

Simplo Technology Co., Ltd.

Skyworks Solutions Inc.

Sony Corporation

Standard Microsystems Corporation

STMicroelectronics

Sumida Corporation

Sumitomo Electric Industries, Ltd.

Sunrex Technology Corporation

Suzhou Panel Electronic Co., Ltd.

Taiyi Precision Tech Corporation

Taiyo Yuden Co., Ltd.

TDK Corporation
Texas Instruments Inc.

Tianjin Lishen Battery Joint-Stock Co., Ltd.

Toshiba Corporation

Toshiba Mobile Display Co., Ltd.

Toyo Rikagaku Kenkyusho Co., Ltd.

TPK Holding Co., Ltd.

Tripod Technology Corporation

TriQuint Semiconductor

Triumph Lead Electronic Tech Co.

TXC Corporation

Unimicron Corporation

Unisteel Technology Ltd.

Universal Scientific Industrial Co., Ltd.

Vishay Intertechnology

Volex plc

Western Digital Corporation

Wintek Corporation

yageo Corporation

Zeniya Aluminum Engineering, Ltd.
","['aapl', 'releas', 'list', 'supplier', 'most', 'compani', 'known', 'appl', 'supplier', ',', 'may', 'new', 'name', '.', 'usual', 'previous', 'unknown', 'compani', 'come', 'supplier', ',', 'see', 'big', 'move', 'stock', 'public', '.', 'appl', 'supplier', '2011', 'aac', 'technolog', 'hold', 'inc.', 'acbel', 'polytech', 'inc.', 'acument', 'global', 'technolog', 'advanc', 'micro', 'devic', ',', 'inc.', 'amperex', 'technolog', 'ltd.', 'amphenol', 'corpor', 'analog', 'devic', ',', 'inc.', 'anji', 'insul', 'materi', 'co.', ',', 'ltd.', 'asahi', 'kasei', 'corpor', 'au', 'optron', 'corpor', 'austria', 'technologi', '&', 'amp', ';', 'systemtechnik', 'ag', 'austriamicrosystem', 'avago', 'technolog', 'ltd.', 'bradi', 'corpor', 'brilliant', 'intern', 'group', 'ltd.', 'broadcom', 'corpor', 'broadway', 'industri', 'group', 'ltd.', 'byd', 'compani', 'ltd.', 'career', 'technolog', '(', 'mfg', '.', ')', 'catcher', 'technolog', 'co.', ',', 'ltd.', 'cheng', 'loong', 'corpor', 'cheng', 'uei', 'precis', 'industri', 'co.', ',', 'ltd.', '(', 'foxlink', ')', 'chimei', 'innolux', 'corpor', 'coilcraft', ',', 'inc.', 'compeq', 'manufactur', 'co.', ',', 'ltd.', 'cosmosupplylab', 'ltd.', 'cymmetrik', '(', 'shenzhen', ')', 'print', 'co', 'cyntec', 'co.', ',', 'ltd.', 'cypress', 'semiconductor', 'corpor', 'daishinku', 'corpor', '(', 'kd', ')', 'darfon', 'electron', 'corpor', 'delta', 'electron', 'inc.', 'diod', 'inc.', 'dynapack', 'intern', 'technolog', 'elpida', 'memori', ',', 'inc.', 'emerson', 'electr', 'co.', 'es', 'power', 'co.', ',', 'ltd.', 'fairchild', 'semiconductor', 'intern', 'fasten', 'technolog', 'pte', 'ltd.', 'flexium', 'interconnect', ',', 'inc.', 'flextron', 'intern', 'ltd.', 'fortun', 'grand', 'enterpris', 'co.', ',', 'ltd.', 'foster', 'electr', 'co.', ',', 'ltd.', 'fuji', 'crystal', 'manufactori', 'ltd.', 'fujikura', 'ltd.', 'grand', 'upright', 'technolog', 'ltd.', 'gruppo', 'dani', 's.p.a.', 'gruppo', 'peretti', 'hama', 'naka', 'shoukin', 'industri', 'co.', ',', 'ltd.', 'hanson', 'metal', 'factori', 'ltd.', 'heptagon', 'advanc', 'micro-opt', 'pte', 'ltd.', 'hi-p', 'intern', 'ltd.', 'hitachi-lg', 'data', 'storag', 'hon', 'hai', 'precis', 'industri', 'co.', ',', 'ltd.', '(', 'foxconn', ')', 'hynix', 'semiconductor', 'inc.', 'ibiden', 'co.', ',', 'ltd.', 'infineon', 'technolog', 'ag', 'intel', 'corpor', 'interflex', 'co.', ',', 'ltd.', 'intern', 'rectifi', 'corpor', 'intersil', 'corpor', 'inventec', 'applianc', 'corpor', 'jabil', 'circuit', ',', 'inc.', 'japan', 'aviat', 'electron', 'industri', ',', 'ltd.', 'jin', 'li', 'mould', 'manufactur', 'pte', 'ltd.', 'kaili', 'packag', 'pte', 'ltd.', 'kenseisha', 'sdn', '.', 'bhd', '.', 'knowl', 'electron', 'kunshan', 'changyun', 'electron', 'industri', 'laird', 'technolog', 'later', 'solut', 'pte', 'ltd', '.', 'len', 'one', 'technolog', '(', 'shenzhen', ')', 'co.', ',', 'ltd.', 'lg', 'chem', ',', 'ltd.', 'lg', 'display', 'co.', ',', 'ltd.', 'lg', 'innotek', 'co.', ',', 'ltd', '.', 'linear', 'technolog', 'corpor', 'lite-on', 'technolog', 'corpor', 'longwel', 'compani', 'lsi', 'corpor', 'luen', 'fung', 'commerci', 'hold', 'ltd.', 'macronix', 'intern', 'co.', ',', 'ltd.', 'marian', ',', 'inc.', 'marvel', 'technolog', 'group', 'ltd.', 'maxim', 'integr', 'product', ',', 'inc.', 'meiko', 'electron', 'co.', ',', 'ltd', '.', 'microchip', 'technolog', 'inc.', 'micron', 'technolog', ',', 'inc.', 'mitsumi', 'electr', 'co.', ',', 'ltd.', 'molex', 'inc.', 'multek', 'corpor', 'multi-finelin', 'electronix', ',', 'inc.', 'murata', 'manufactur', 'co.', ',', 'ltd.', 'nan', 'ya', 'print', 'circuit', 'board', 'corpor', 'nec', 'corpor', 'nippon', 'mektron', ',', 'ltd.', 'nishoku', 'technolog', 'inc.', 'nvidia', 'corpor', 'nxp', 'semiconductor', 'n.v.', 'on', 'semiconductor', 'corpor', 'optrex', 'corpor', 'orient', 'print', 'circuit', 'ltd.', 'panason', 'corpor', 'pch', 'intern', 'pegatron', 'corpor', 'pioneer', 'materi', 'precis', 'tech', 'prent', 'corpor', 'primax', 'electron', 'ltd.', 'qualcomm', 'incorpor', 'quanta', 'comput', 'inc.', 'renesa', 'electron', 'corpor', 'ri-teng', 'comput', 'accessori', 'co.', ',', 'ltd.', 'rohm', 'co.', ',', 'ltd.', 'rubycon', 'corpor', 'samsung', 'electro-mechan', 'co.', ',', 'ltd.', 'samsung', 'electron', 'co.', ',', 'ltd.', 'sandisk', 'corpor', 'sanyo', 'electr', 'co.', ',', 'ltd.', 'sdi', 'corpor', 'seagat', 'technolog', 'seiko', 'epson', 'corpor', 'seiko', 'group', 'sharp', 'corpor', 'shimano', 'inc.', 'shin', 'zu', 'shing', 'co.', ',', 'ltd.', 'silego', 'technolog', 'inc.', 'simplo', 'technolog', 'co.', ',', 'ltd.', 'skywork', 'solut', 'inc.', 'soni', 'corpor', 'standard', 'microsystem', 'corpor', 'stmicroelectron', 'sumida', 'corpor', 'sumitomo', 'electr', 'industri', ',', 'ltd.', 'sunrex', 'technolog', 'corpor', 'suzhou', 'panel', 'electron', 'co.', ',', 'ltd.', 'taiyi', 'precis', 'tech', 'corpor', 'taiyo', 'yuden', 'co.', ',', 'ltd.', 'tdk', 'corpor', 'texa', 'instrument', 'inc.', 'tianjin', 'lishen', 'batteri', 'joint-stock', 'co.', ',', 'ltd.', 'toshiba', 'corpor', 'toshiba', 'mobil', 'display', 'co.', ',', 'ltd.', 'toyo', 'rikagaku', 'kenkyusho', 'co.', ',', 'ltd.', 'tpk', 'hold', 'co.', ',', 'ltd.', 'tripod', 'technolog', 'corpor', 'triquint', 'semiconductor', 'triumph', 'lead', 'electron', 'tech', 'co.', 'txc', 'corpor', 'unimicron', 'corpor', 'unisteel', 'technolog', 'ltd.', 'univers', 'scientif', 'industri', 'co.', ',', 'ltd.', 'vishay', 'intertechnolog', 'volex', 'plc', 'western', 'digit', 'corpor', 'wintek', 'corpor', 'yageo', 'corpor', 'zeniya', 'aluminum', 'engin', ',', 'ltd', '.']",[50  9  0 ...  0  0  0],5
560,5,Tomorrow’s Tape: Consumer Credit on Tap,5,0,0,,"['tomorrow', '’', 'tape', ':', 'consum', 'credit', 'tap', 'nan']",[0 0 0 ... 0 0 0],5
856,3,"VIX remains near historic lows as complacency 
prevails in equity markets in spite of significant 
headwinds like the fiscal cliff and a slowing economy",5,2,6,,"['vix', 'remain', 'near', 'histor', 'low', 'complac', 'prevail', 'equiti', 'market', 'spite', 'signific', 'headwind', 'like', 'fiscal', 'cliff', 'slow', 'economi', 'nan']",[0 0 0 ... 0 0 0],5
747,5,"Stocks to Watch: Frontline, VeriFone Systems, Talbots",5,0,1,,"['stock', 'watch', ':', 'frontlin', ',', 'verifon', 'system', ',', 'talbot', 'nan']",[2 0 0 ... 0 0 0],5
252,7,"Stocks Jump Nearly 2% on Jobs, ISM Reports",8,1,0,,"['stock', 'jump', 'nearli', '2', '%', 'job', ',', 'ism', 'report', 'nan']",[1 0 0 ... 0 0 0],5
21,21,"Shares of Apple Inc. slid more than 10% on Thursday, tripping a Nasdaq circuit breaker",21,0,4,,"['share', 'appl', 'inc.', 'slid', '10', '%', 'thursday', ',', 'trip', 'nasdaq', 'circuit', 'breaker', 'nan']",[1 0 0 ... 0 0 0],20
313,7,Moody’s Changes Euro Zone Rating Outlook to ‘Negative’,10,3,4,,"['moodi', '’', 'chang', 'euro', 'zone', 'rate', 'outlook', '‘', 'neg', '’', 'nan']",[0 0 0 ... 0 0 0],5
459,6,DECK -25% ..ouch,7,1,3,"http://finviz.com/chart.ashx?t=DECK&amp;ty=c&amp;ta=1&amp;p=d&amp;s=l

NEW YORK (MarketWatch) — After giving disappointing outlook for the second time since February, Ugg boot maker Deckers Outdoor Corp., which had been a favorite of Wall Street, is raising concerns on several fronts.

Its stock DECK -25.38%  tumbled 26% to $51.67 in its biggest percentage decline ever. The stock this year has dropped 32%, compared to the 24% increase of the S&amp;P Retail Index XX:RLX +3.56%  during the same period.

Analysts at Jefferies, Canaccord Genuity and Northland Securities all downgraded the stock. Still, about two-thirds of 17 analysts covering the stock rated the stock a buy earlier this month, down from 86% of them in August last year, FactSet data showed. ","['deck', '-25', '%', '..', 'ouch', 'http', ':', '//finviz.com/chart.ashx', '?', 't=deck', '&', 'amp', ';', 'ty=c', '&', 'amp', ';', 'ta=1', '&', 'amp', ';', 'p=d', '&', 'amp', ';', 's=l', 'new', 'york', '(', 'marketwatch', ')', '—', 'after', 'give', 'disappoint', 'outlook', 'second', 'time', 'sinc', 'februari', ',', 'ugg', 'boot', 'maker', 'decker', 'outdoor', 'corp.', ',', 'favorit', 'wall', 'street', ',', 'rais', 'concern', 'sever', 'front', '.', 'it', 'stock', 'deck', '-25.38', '%', 'tumbl', '26', '%', '$', '51.67', 'biggest', 'percentag', 'declin', 'ever', '.', 'the', 'stock', 'year', 'drop', '32', '%', ',', 'compar', '24', '%', 'increas', 's', '&', 'amp', ';', 'p', 'retail', 'index', 'xx', ':', 'rlx', '+3.56', '%', 'period', '.', 'analyst', 'jefferi', ',', 'canaccord', 'genuiti', 'northland', 'secur', 'downgrad', 'stock', '.', 'still', ',', 'two-third', '17', 'analyst', 'cover', 'stock', 'rate', 'stock', 'buy', 'earlier', 'month', ',', '86', '%', 'august', 'last', 'year', ',', 'factset', 'data', 'show', '.']",[8 5 0 ... 0 0 0],5
160,9,All good news everywhere! Not a cloud in the sky!,11,2,20,"So lets see here..

1) AAPL declares the much awaited dividend and to top it all off, a share buy back!

2) BAC was at $8 and climbs +25% hits $10 because JPM declares a dividend. Financials now rallying like crazy!

3) Greece? Long forgotten. Spain? Portugal? Not important.



S&amp;P flirting with 1410 here, the market is looking amazingly strong!

I want to check back and read this post in two months from now and see what we missed.

","['all', 'good', 'news', 'everywher', '!', 'not', 'cloud', 'sky', '!', 'so', 'let', 'see', '..', '1', ')', 'aapl', 'declar', 'much', 'await', 'dividend', 'top', ',', 'share', 'buy', 'back', '!', '2', ')', 'bac', '$', '8', 'climb', '+25', '%', 'hit', '$', '10', 'jpm', 'declar', 'dividend', '.', 'financi', 'ralli', 'like', 'crazi', '!', '3', ')', 'greec', '?', 'long', 'forgotten', '.', 'spain', '?', 'portug', '?', 'not', 'import', '.', 's', '&', 'amp', ';', 'p', 'flirt', '1410', ',', 'market', 'look', 'amazingli', 'strong', '!', 'i', 'want', 'check', 'back', 'read', 'post', 'two', 'month', 'see', 'miss', '.']",[2 4 0 ... 0 0 0],10
276,8,Elliott Wave on 30 year T-bill,14,6,14,,"['elliott', 'wave', '30', 'year', 't-bill', 'nan']",[0 0 0 ... 0 0 0],10
955,3,"Dollar spiking here, Gold down, FOMC summary",3,0,7,"    FOMC SAW NO NEED TO EASE ANEW UNLESS GROWTH SLOWS, MINUTES SHOW
    MOST FOMC PARTICIPANTS SAW `LITTLE EVIDENCE OF COST PRESSURES
    FOMC PARTICIPANTS SAID LABOR MARKET CONDITIONS HAD IMPROVED
    MOST FOMC PARTICIPANTS EXPECTED INFLATION RATE AT 2% OR LESS
    MANY FOMC PARTICIPANTS SAW `EASED' STRAINS IN GLOBAL MARKETS
    MOST ON FOMC SAW TEMPORARY IMPACT FROM RISING OIL, GAS PRICES
    FOMC SAID SIGNIFICANT OUTLOOK CHANGE COULD ALTER 2014 RATE PLAN

Source: Zerohedge","['dollar', 'spike', ',', 'gold', ',', 'fomc', 'summari', 'fomc', 'saw', 'no', 'need', 'to', 'eas', 'anew', 'unless', 'growth', 'slow', ',', 'minut', 'show', 'most', 'fomc', 'particip', 'saw', '`', 'littl', 'evid', 'of', 'cost', 'pressur', 'fomc', 'particip', 'said', 'labor', 'market', 'condit', 'had', 'improv', 'most', 'fomc', 'particip', 'expect', 'inflat', 'rate', 'at', '2', '%', 'or', 'less', 'mani', 'fomc', 'particip', 'saw', '`', 'eas', ""'"", 'strain', 'in', 'global', 'market', 'most', 'on', 'fomc', 'saw', 'temporari', 'impact', 'from', 'rise', 'oil', ',', 'ga', 'price', 'fomc', 'said', 'signific', 'outlook', 'chang', 'could', 'alter', '2014', 'rate', 'plan', 'sourc', ':', 'zerohedg']",[4 0 0 ... 0 0 0],5
191,9,"Euro near two-week lows, market awaits Spain budget ",9,0,0,,"['euro', 'near', 'two-week', 'low', ',', 'market', 'await', 'spain', 'budget', 'nan']",[1 0 0 ... 0 0 0],10
385,4,WLT technical trade on break out over $20,6,2,5,,"['wlt', 'technic', 'trade', 'break', '$', '20', 'nan']",[0 0 0 ... 0 0 0],5
805,3,Blackberry (BBRY) weighing option to sell itself off,5,2,0,,"['blackberri', '(', 'bbri', ')', 'weigh', 'option', 'sell', 'nan']",[0 0 0 ... 0 0 0],5
413,6,"LNKD breaks down on FB Jobs App news, recovering as market realizes this was expected",7,1,1,The stock market is a silly place sometimes. ,"['lnkd', 'break', 'fb', 'job', 'app', 'news', ',', 'recov', 'market', 'realiz', 'expect', 'the', 'stock', 'market', 'silli', 'place', 'sometim', '.']",[1 1 0 ... 0 0 0],5
491,4,EWT on gold in compliment to EWT forecast on GDX,7,3,10,,"['ewt', 'gold', 'compliment', 'ewt', 'forecast', 'gdx', 'nan']",[0 0 0 ... 0 0 0],5
343,7,S&amp;P 500 possible target,7,0,5,,"['s', '&', 'amp', ';', 'p', '500', 'possibl', 'target', 'nan']",[0 0 0 ... 0 0 0],5
769,4,SVU +17% pop on earnings,4,0,0,"optionMONSTER - Supervalu reported a fourth-quarter profit of $0.38 a share excluding charges. On that basis, analysts had expected the heavily shorted, debt-laden grocery to earn just $0.35. SVU climbs 14 percent before the bell.

http://finviz.com/quote.ashx?t=svu","['svu', '+17', '%', 'pop', 'earn', 'optionmonst', '-', 'supervalu', 'report', 'fourth-quart', 'profit', '$', '0.38', 'share', 'exclud', 'charg', '.', 'on', 'basi', ',', 'analyst', 'expect', 'heavili', 'short', ',', 'debt-laden', 'groceri', 'earn', '$', '0.35', '.', 'svu', 'climb', '14', 'percent', 'bell', '.', 'http', ':', '//finviz.com/quote.ashx', '?', 't=svu']",[2 3 0 ... 0 0 0],5
308,7,"Pandora -20%, word is AAPL launches a music service",7,0,8,"Stock was halted, just reopened. 

AAPL going to eat their pie.","['pandora', '-20', '%', ',', 'word', 'aapl', 'launch', 'music', 'servic', 'stock', 'halt', ',', 'reopen', '.', 'aapl', 'go', 'eat', 'pie', '.']",[2 2 0 ... 0 0 0],5
661,4,CTGO... Spin-off of MCF starting to show signs of life.  Intelligent Spec!,4,0,0,,"['ctgo', '...', 'spin-off', 'mcf', 'start', 'show', 'sign', 'life', '.', 'intellig', 'spec', '!', 'nan']",[0 1 0 ... 0 0 0],5
130,10,Testing a P/E strategy,12,2,9,"The company CVTI posted lackluster earnings this week, cutting their EPS total over the past 4 quarters in half (.16 down from .32).  Thus, their P/E ratio, which has been tracking around 20, has suddenly jumped to a whopping 40.  

http://www.google.com/finance?q=NASDAQ%3ACVTI&amp;ei=O8PyUaDUGKTGlgO-vAE

By contrast, the vast majority of their competitors (they are a shipping/transportation company) are still tracking at ~20:

http://www.google.com/finance?q=NYSE:KNX&amp;ei=PcPyUbGZHKWqlwPI-QE

http://www.google.com/finance?q=NYSE:CGI&amp;ei=PcPyUbGZHKWqlwPI-QE

http://www.google.com/finance?q=NYSE:SWFT&amp;ei=PcPyUbGZHKWqlwPI-QE

http://www.google.com/finance?q=NASDAQ:WERN&amp;ei=PcPyUbGZHKWqlwPI-QE

http://www.google.com/finance?q=NASDAQ:MRTN&amp;ei=PcPyUbGZHKWqlwPI-QE

http://www.google.com/finance?q=NASDAQ:UACL&amp;ei=PcPyUbGZHKWqlwPI-QE

http://www.google.com/finance?q=NASDAQ:HTLD&amp;ei=PcPyUbGZHKWqlwPI-QE

http://www.google.com/finance?q=NYSE:RRTS&amp;ei=PcPyUbGZHKWqlwPI-QE

http://www.google.com/finance?q=NASDAQ:ODFL&amp;ei=KsTyUaifDZ3glgPfZw

So, based on this logic, I am anticipating a large swing downward over the next 3 weeks in order to bring P/E back into alignment.  I'll see you all in 1-3 weeks to post the results of this study.

  ","['test', 'p/e', 'strategi', 'the', 'compani', 'cvti', 'post', 'lacklust', 'earn', 'week', ',', 'cut', 'ep', 'total', 'past', '4', 'quarter', 'half', '(', '.16', '.32', ')', '.', 'thu', ',', 'p/e', 'ratio', ',', 'track', 'around', '20', ',', 'suddenli', 'jump', 'whop', '40.', 'http', ':', '//www.google.com/fin', '?', 'q=nasdaq', '%', '3acvti', '&', 'amp', ';', 'ei=o8pyuadugktglgo-va', 'by', 'contrast', ',', 'vast', 'major', 'competitor', '(', 'shipping/transport', 'compani', ')', 'still', 'track', '~20', ':', 'http', ':', '//www.google.com/fin', '?', 'q=nyse', ':', 'knx', '&', 'amp', ';', 'ei=pcpyubgzhkwqlwpi-q', 'http', ':', '//www.google.com/fin', '?', 'q=nyse', ':', 'cgi', '&', 'amp', ';', 'ei=pcpyubgzhkwqlwpi-q', 'http', ':', '//www.google.com/fin', '?', 'q=nyse', ':', 'swft', '&', 'amp', ';', 'ei=pcpyubgzhkwqlwpi-q', 'http', ':', '//www.google.com/fin', '?', 'q=nasdaq', ':', 'wern', '&', 'amp', ';', 'ei=pcpyubgzhkwqlwpi-q', 'http', ':', '//www.google.com/fin', '?', 'q=nasdaq', ':', 'mrtn', '&', 'amp', ';', 'ei=pcpyubgzhkwqlwpi-q', 'http', ':', '//www.google.com/fin', '?', 'q=nasdaq', ':', 'uacl', '&', 'amp', ';', 'ei=pcpyubgzhkwqlwpi-q', 'http', ':', '//www.google.com/fin', '?', 'q=nasdaq', ':', 'htld', '&', 'amp', ';', 'ei=pcpyubgzhkwqlwpi-q', 'http', ':', '//www.google.com/fin', '?', 'q=nyse', ':', 'rrt', '&', 'amp', ';', 'ei=pcpyubgzhkwqlwpi-q', 'http', ':', '//www.google.com/fin', '?', 'q=nasdaq', ':', 'odfl', '&', 'amp', ';', 'ei=kstyuaifdz3glgpfzw', 'so', ',', 'base', 'logic', ',', 'i', 'anticip', 'larg', 'swing', 'downward', 'next', '3', 'week', 'order', 'bring', 'p/e', 'back', 'align', '.', 'i', ""'ll"", 'see', '1-3', 'week', 'post', 'result', 'studi', '.']",[7 3 0 ... 0 0 0],10
663,4,Where to start?,7,3,16,"I'm a college student and am interested in investing in a few penny stocks. I only plan investing around $1000, with that in mind where is a good place to open an account?","['where', 'start', '?', 'i', ""'m"", 'colleg', 'student', 'interest', 'invest', 'penni', 'stock', '.', 'i', 'plan', 'invest', 'around', '$', '1000', ',', 'mind', 'good', 'place', 'open', 'account', '?']",[1 1 0 ... 0 0 0],5
871,3,Tokushima Worldwide - Shell Oil Begins Exploratory Drilling.,8,5,0,,"['tokushima', 'worldwid', '-', 'shell', 'oil', 'begin', 'exploratori', 'drill', '.', 'nan']",[0 1 0 ... 0 0 0],5
99,12,Home Starts Jump to Four-Year U.S. High,12,0,5,,"['home', 'start', 'jump', 'four-year', 'u.s.', 'high', 'nan']",[0 0 0 ... 0 0 0],10
372,5,Mark's Weekly Trading Log (7/8-7/12) Charts Analysis and Video,6,1,1,,"['mark', ""'s"", 'weekli', 'trade', 'log', '(', '7/8-7/12', ')', 'chart', 'analysi', 'video', 'nan']",[0 0 0 ... 0 0 0],5
87,13,Gold breaking below long term trend,17,4,5,,"['gold', 'break', 'long', 'term', 'trend', 'nan']",[0 0 0 ... 0 0 0],15
458,6,EURUSD being kind to me today,6,0,3,"Dollar got a bid in the last hour, EURUSD hitting 1.3104 now, Im hoping we take out 1.3100 and test thos 1.3050 levels.","['eurusd', 'kind', 'today', 'dollar', 'got', 'bid', 'last', 'hour', ',', 'eurusd', 'hit', '1.3104', ',', 'im', 'hope', 'take', '1.3100', 'test', 'tho', '1.3050', 'level', '.']",[2 1 0 ... 0 0 0],5
330,6,TA meets Fundamentals: Consumer Confidence drops to 5 month lows. XRT sitting on support.,7,1,1,"Bloomberg piece on [consumer confidence dropping](http://www.bloomberg.com/news/2012-06-26/consumer-confidence-in-u-s-dropped-to-a-five-month-low-in-june.html) to 5 month lows.

[Chart of the XRT](http://www.hotstockmarket.com/t/234242/bloomberg-u-s-consumer-confidence-hits-5-month-low#post_2873348)

If consumer confidence is sucking wind, people are spending less, XRT would be a great way to play it.

No position here, just thinking out loud.

","['ta', 'meet', 'fundament', ':', 'consum', 'confid', 'drop', '5', 'month', 'low', '.', 'xrt', 'sit', 'support', '.', 'bloomberg', 'piec', '[', 'consum', 'confid', 'drop', ']', '(', 'http', ':', '//www.bloomberg.com/news/2012-06-26/consumer-confidence-in-u-s-dropped-to-a-five-month-low-in-june.html', ')', '5', 'month', 'low', '.', '[', 'chart', 'xrt', ']', '(', 'http', ':', '//www.hotstockmarket.com/t/234242/bloomberg-u-s-consumer-confidence-hits-5-month-low', '#', 'post_2873348', ')', 'if', 'consum', 'confid', 'suck', 'wind', ',', 'peopl', 'spend', 'less', ',', 'xrt', 'would', 'great', 'way', 'play', '.', 'no', 'posit', ',', 'think', 'loud', '.']",[3 5 0 ... 0 0 0],5
214,9,"New iPad is out, its the iPad3 but has 4G and siri, better screen.",10,1,18,"Is it enough to make you run out and wait in line to buy it?

I think I may pass and wait for the next one :P

http://www.engadget.com/2012/03/07/the-new-ipad-is-official/","['new', 'ipad', ',', 'ipad3', '4g', 'siri', ',', 'better', 'screen', '.', 'is', 'enough', 'make', 'run', 'wait', 'line', 'buy', '?', 'i', 'think', 'i', 'may', 'pass', 'wait', 'next', 'one', ':', 'p', 'http', ':', '//www.engadget.com/2012/03/07/the-new-ipad-is-official/']",[2 1 0 ... 0 0 0],10
466,7,"LGF - Lions Gate upgraded, target $19",7,0,10,"Forbes - This morning, Stifel Nicolaus increased its price target on shares of Lions Gate (LGF) to $19 following strong box office results from the Hunger Games release.  With the higher price target, Stifel raised its EPS estimates and reiterated its buy rating.

Shares of LGF were higher on Monday, gaining 3.2% so far.","['lgf', '-', 'lion', 'gate', 'upgrad', ',', 'target', '$', '19', 'forb', '-', 'thi', 'morn', ',', 'stifel', 'nicolau', 'increas', 'price', 'target', 'share', 'lion', 'gate', '(', 'lgf', ')', '$', '19', 'follow', 'strong', 'box', 'offic', 'result', 'hunger', 'game', 'releas', '.', 'with', 'higher', 'price', 'target', ',', 'stifel', 'rais', 'ep', 'estim', 'reiter', 'buy', 'rate', '.', 'share', 'lgf', 'higher', 'monday', ',', 'gain', '3.2', '%', 'far', '.']",[4 3 0 ... 0 0 0],5
121,12,PCLN down $104 per share in pre-market.,13,1,4,,"['pcln', '$', '104', 'per', 'share', 'pre-market', '.', 'nan']",[0 1 0 ... 0 0 0],10
614,6,"Learn the difference between VIX, VXX, TVIX",6,0,3,,"['learn', 'differ', 'vix', ',', 'vxx', ',', 'tvix', 'nan']",[2 0 0 ... 0 0 0],5
20,20,New rules in the side bar: Be respectful to other traders,24,4,18,"As this subreddit grows and in order to foster a helpful and educational environment, we added a new rule that will be strictly enforced.

Be respectful of other traders and investors.

We want to encourage questions and commentary from all levels. Beginners to veterans, all are welcome to share ideas and thoughts. 

Any member found to be trolling, attacking, insulting, or just being an ass because their Daddy did not love them enough, will be banned.

Thank you and may the profits be with you.","['new', 'rule', 'side', 'bar', ':', 'be', 'respect', 'trader', 'as', 'subreddit', 'grow', 'order', 'foster', 'help', 'educ', 'environ', ',', 'ad', 'new', 'rule', 'strictli', 'enforc', '.', 'be', 'respect', 'trader', 'investor', '.', 'we', 'want', 'encourag', 'question', 'commentari', 'level', '.', 'beginn', 'veteran', ',', 'welcom', 'share', 'idea', 'thought', '.', 'ani', 'member', 'found', 'troll', ',', 'attack', ',', 'insult', ',', 'ass', 'daddi', 'love', 'enough', ',', 'ban', '.', 'thank', 'may', 'profit', '.']",[6 6 0 ... 0 0 0],20
700,4,Repetitive patterns and long term view from Oscar,5,1,3,,"['repetit', 'pattern', 'long', 'term', 'view', 'oscar', 'nan']",[0 0 0 ... 0 0 0],5
71,15,"FB to launch job posting site, will compete with LinkedIn. LNKD -6%",15,0,10,,"['fb', 'launch', 'job', 'post', 'site', ',', 'compet', 'linkedin', '.', 'lnkd', '-6', '%', 'nan']",[1 1 0 ... 0 0 0],15
106,11,Research in Motion Gets 4 Downgrades,16,5,10,,"['research', 'motion', 'get', '4', 'downgrad', 'nan']",[0 0 0 ... 0 0 0],10
270,9,"Short term ES (S&amp;P futures), possible one more leg down.",9,0,4,,"['short', 'term', 'es', '(', 's', '&', 'amp', ';', 'p', 'futur', ')', ',', 'possibl', 'one', 'leg', '.', 'nan']",[1 1 0 ... 0 0 0],10
860,4,What in the world happened here?!?,6,2,7,,"['what', 'world', 'happen', '?', '!', '?', 'nan']",[0 0 0 ... 0 0 0],5
435,8,Stocks decline ahead of Geithner-Draghi meeting,9,1,0,,"['stock', 'declin', 'ahead', 'geithner-draghi', 'meet', 'nan']",[0 0 0 ... 0 0 0],10
102,14,Algo's gone wild!,14,0,21,"KO:
http://imgur.com/uRznn


IBM:
http://i.imgur.com/RBFD6.png","['algo', ""'s"", 'gone', 'wild', '!', 'ko', ':', 'http', ':', '//imgur.com/urznn', 'ibm', ':', 'http', ':', '//i.imgur.com/rbfd6.png']",[0 0 0 ... 0 0 0],15
